云龙区杨八矿珠宝中心	杨八矿珠宝
北京家长村科技有限公司	家长村
江苏苏宁易购电子商务有限公司	苏宁易购
江苏夏方健康咨询服务有限公司	夏方
深汕特别合作区南之亿电子商务有限公司	深汕特别区南之亿
天津龙和隆盛化妆品销售有限公司	龙和隆盛
本来实业（重庆）有限公司	本来
深圳市爆品时代信息技术有限公司	爆品时代
中江县白果乡无羡蓝忘食品经营部	白果乡无羡蓝忘
广州市墨尘电子商务有限公司	墨尘
故城县郑口轩帅服装店	郑口轩帅服装店
云南佰帘惠遮阳设备有限公司	佰帘惠遮阳
长沙小野文化传媒有限责任公司	小野
广东投资快报传媒有限责任公司	快报
邵阳县塘渡口镇迅之达贸易商行	塘渡口镇迅之达贸易商行
襄阳乐菲雅商贸有限公司	乐菲雅
杭州聚米网络技术有限公司	聚米
四川奇速教育科技有限公司	奇速
上海云拼网络科技有限公司	云拼
上海珑理贸易有限公司	珑理
义乌市月弧电子商务商行	月弧商行
烟台林鲜生食品有限公司	林鲜生
苏州希康爱商贸有限公司	希康爱
成都贝约电子商务有限公司	贝约
玉田县鸦鸿桥镇凯翔商店	鸦鸿桥镇凯翔商店
太原市万柏林区诗雨书店	诗雨书店
临清市尚店镇胜磊养殖场	尚店镇胜磊养殖场
上海卿鑫服饰有限公司	卿鑫
梅州市楚和堂生物科技有限公司	楚和堂
安徽森昱商贸有限公司	森昱
天津云知浩瀚信息技术有限公司	云知浩瀚
清河县启波绒毛加工厂	启波绒毛加工厂
郑州逸赋堂健康科技有限公司	逸赋堂
山东驷驰电力科技有限公司	驷驰
广州零度互动网络科技有限公司	零度互动
杭州得赋科技有限公司	得赋
大泉（上海）自动化科技有限公司	大泉
深圳市宏河电子商务有限公司	宏河
深圳美丝纺家居饰品有限公司	美丝纺家居饰品
贵州省仁怀市云起酒业销售有限公司	云起
酉阳县兴成建材商行	酉阳县兴成建材商行
西安微观商学网络科技有限公司	微观商学
义乌升信日用百货有限公司	升信日用百货
涿州市墨雅艺术品销售部	墨雅艺术品销售部
武汉博雅轩文化科技有限公司	博雅轩
东莞市纬球电气科技有限公司	纬球
西咸新区沣东新城未科诚百货店	西咸新区沣东未科诚百货店
信阳市羊山新区沐香干果食品店	羊山新区沐香干果食品店
潍坊乐卓网络传媒有限公司	乐卓网络传媒
渝中区阿依图娜土特产店	阿依图娜土特产店
郑州村头电子商务有限公司	村头
上海能良电子科技有限公司	能良
嵩县保会电机维修店	保会维修店
深圳市星佳贸易有限公司	星佳
徐州装小宅家居有限公司	装小宅家居
慈利县山水韵商行	山水韵商行
南通喜庄家纺有限公司	喜庄家纺
洛阳市西工区全盛物资部	全盛物资部
毕节金海湖新区萧恒散酒经营部	金海湖新区萧恒散酒
昆山市玉山镇萱萱家童装店	玉山镇萱萱家童装店
北京筹令文化有限公司	筹令
临沂韩强工程洗车机有限公司	韩强洗车机
易县山村小龙调味品坊	山村小龙调味品坊
广州万信汽车销售有限公司	万信
大连因卓翼教育科技有限公司	因卓翼
重庆点击互动网络科技有限公司	点击互动
珠海市羽山电子商务有限公司	羽山
东海县慈青阁珠宝有限公司	慈青阁珠宝
桥西区昌和茶行	昌和茶行
武汉研妆生物科技有限公司	研妆
黄岛区辰嘉威商贸店	辰嘉威店
义乌市真燕纺织有限公司	真燕
滨海泓乐酒行	泓乐酒行
深圳车仆实业有限公司	车仆
宁津铭亿机械设备有限公司	铭亿
联通华盛通信有限公司辽宁分公司	联通华盛
瑞丽市蒲全珠宝店	蒲全珠宝店
扶余市陶赖昭禾平米业有限责任公司	市陶赖昭禾平米业
郑州市管城回族区咔悠化妆品商行	管城回族区咔悠商行
苏州逗学信息科技有限公司	逗学
邵东县流泽镇博乐机械厂	流泽镇机械厂
北京萃生堂商贸有限公司	萃生堂
山西广信通茂科技有限公司	广信通茂
上海爱婴室电子商务有限公司	爱婴室
四川锦睿智诚科技有限公司	锦睿智诚
深圳市优禄贸易有限公司	优禄
河北福到家纸业有限公司	福到家纸业
西安旭龙网络科技有限公司	旭龙
绵阳市游仙区百科商行	百科商行
锦江区花花世界广告设计工作室	花花世界工作室
深圳盛世兴收科技有限公司	盛世兴收
福州市仓山区长河商贸店	长河店
河南三泰药业有限公司	三泰
菏泽市牡丹区瀚轩斋书画艺术有限公司	瀚轩斋书画艺术
深圳市蓝鱼亚新科技有限公司	蓝鱼亚新
菏泽市牡丹区来通百货商行	来通百货商行
随州锦妍商贸有限公司	锦妍
嘉兴市秀洲区洪合镇韵安服装厂	洪合镇韵安服装厂
李康	李康
郑州康勤电子科技有限公司	康勤
浚县爱梦丽服装经营部	爱梦丽
沈阳市大东区伟鑫燕床垫家具批发经销处	伟鑫燕床垫家具经销处
普宁市追梦团商贸有限公司	追梦团
北京丁丁时代科技有限责任公司	丁丁时代
山东双击文化传媒有限公司	双击
阜新嘉客多电子商务有限公司	嘉客多
宿豫区茂之利商贸中心	茂之利
烟台磐瑞喜医药生物科技有限公司	磐瑞喜医药
深圳市智选优品电子商务有限公司	智选优品
包头市骞味贸易有限公司	骞味
义乌市御旭电子商务商行	御旭商行
兴仁市薏仁源农产品销售店	市薏仁源农产品销售店
徐州市德盟商贸有限公司	德盟
广西灵山县优诺苗木培育有限公司	优诺苗木培育
内蒙古宏图鼎创科技有限公司	宏图鼎创
北京双向养育教育科技有限公司	双向养育
山东鲜馥农业有限公司	鲜馥
西安物易汇传网络科技有限公司	物易汇传
成都美昕尔电子商务有限公司	美昕尔
黑龙江省路美新材料科技有限公司	路美新
云南利他实业（集团）有限公司	利他
广州金纺服饰有限公司	金纺
江苏贝基网络科技有限公司	贝基
美时杰（北京）科技发展有限公司	美时杰
武夷山远致茶业有限公司	远致茶业
岫岩满族自治县康健百货商行	康健百货商行
邵阳市双清区呙记食品商贸	呙记
河南嵩高生物技术有限公司	嵩高
清远市清新区太和镇素明特产店	区镇素明特产店
幸运琪琪科技（天津）有限公司	幸运琪琪
天津鑫正拓达国际贸易有限公司	鑫正拓达
湖北十贤信息科技有限公司	十贤
深圳动进智能科技有限公司	动进智能
湖南易买电子商务有限公司	易买
杭州富阳区洞桥镇辰轩木制工艺品厂	区洞桥镇辰轩木制工艺品厂
兰山区绿雅百货综合店	绿雅百货综合店
兰州梦想网络科技有限公司	梦想
屏南县耀灵日用品商行	耀灵日用品商行
刚森（北京）商贸有限公司	刚森
贵州酒神驾到酒业有限责任公司	酒神驾到
晋州市小云百货经销店	小云百货经销店
畅汇泰达（天津）科技有限公司	畅汇泰达
中银金行股份有限公司	中银金行股份
北京伊禾赛生鲜食品有限公司	伊禾赛生鲜食品
南浔奇拳工艺品店	奇拳工艺品店
济南跨界电子商务有限公司	跨界
东莞市云仙硅胶模型设计有限公司	云仙硅胶
晋城市百迅网络科技有限公司	百迅
深圳市卓宝大健康医药管理有限公司	卓宝大医药
义乌市容涵服装厂	市容涵服装厂
杭州拾山味网络科技有限公司	拾山味
莆田市假日贸易有限公司	假日
郑州市管城区飞扬酒业商行	管飞扬商行
沧州嘉诺温室大棚设施有限公司	嘉诺温室大棚设施
太仓太美电子商务有限公司	太美
宁津县硕泽通风设备厂	硕泽通风设备厂
兰山区果珍淘货食品店	果珍淘货食品店
如皋市湖悦百货经营部	湖悦百货
义乌市赞成电子商务商行	赞成商行
岫岩满族自治县麦承语网络工作室	麦承语工作室
宁波海曙励信电脑商行	海曙励信电脑商行
上海叠桑科技有限公司	叠桑
四会市申明玉器专柜	申明玉器专柜
南阳市宛城区丽道商贸行	丽道行
沈阳市沈河区微雅百货店	微雅百货店
滕州市敖友百货零售店	敖友百货零售店
莆田市吾家贸易有限公司	吾家
四川易安品生物科技有限公司	易安品
河南丰色亿网络科技有限公司	丰色亿
上海谦寻化妆品商行	谦寻商行
浙江如协网络科技有限公司	如协
巢湖市旺荣百货商行	旺荣百货商行
四川应集科技有限公司	应集
四会市玉之良缘珠宝店	玉之良缘珠宝店
杭州月才老货配件淘宝汽车店	月才老货配件淘宝店
广西玉林桓一贸易有限公司	桓一
嘉兴卡寇丝服饰有限公司	卡寇丝
镇平县田玉苑玉器商行	田玉苑玉器商行
巴马寿夫人健康产业有限公司	巴马寿夫人产业
重庆通茂农业发展有限公司	通茂
上海翊由新材料科技有限公司	翊由新
黄岛区鄂温额萨商贸店	鄂温额萨店
厦门飞彤电子商务有限公司	飞彤
四会瑾青珠宝有限公司	四会瑾青珠宝
杭州稻浪网络科技有限公司	稻浪
义乌市贺闵电子商务商行	贺闵商行
清流县龙津镇瑞元东服装店	龙津镇瑞元东服装店
国美在线电子商务有限公司	国美在线
西安御农甜网络科技有限公司	御农甜
山东琥珀文化传媒有限公司	琥珀
万宁南林小伟菠萝蜜果蔬店	南林小伟菠萝蜜果蔬店
义乌市文肆电子商务商行	文肆商行
海宁市盐官镇仰风服饰店	盐官镇仰风服饰店
西安市未央区彦虎镇百货商行	彦虎镇百货商行
沧州哲航管道有限公司	哲航
中闽在线（厦门）供应链集团有限公司	中闽在线供应链
深圳市藜兰零售中心	藜兰零售
北京糖人奇遇科技有限公司	糖人奇遇
深圳市鼎航科技发展有限公司	鼎航
青岛奥风教育咨询有限公司	奥风
上林县三里红电子商务有限公司	三里红
太原市迎泽区李毅勤摄影工作室	李毅勤摄影工作室
贵州盛广源网络科技有限公司	盛广源
孝感市开发区博海百货经营部	开发区博海百货
会宁县乐逍遥日化用品生活馆	乐逍遥用品
广州纤尚化妆品有限公司	纤尚
上海灵人网络科技有限公司	灵人
吴兴织里彦敏童装经营部	织里彦敏童装
杭州图苏网络科技有限公司	图苏
瑞丽市刘家茂珠宝店	刘家茂珠宝店
茂名市电白区小树家的猫百货店	电白区小树家的猫百货店
南昌酷哦文化传播有限公司	酷哦
广东万雄科技有限公司	万雄
石狮市慈念九服装店	慈念九服装店
淮北市谕口窖酒业有限公司	谕口窖酒业
山西考试无忧电子商务有限公司	考试无忧
合肥恩次幂电子商务有限公司	恩次幂
深圳引力网络科技有限公司	引力
东莞市艺恒电子材料有限公司	艺恒
洛阳市西工区和鞋一生百货商行	和鞋一生百货商行
福州市仓山区星耀箱包店	星耀箱包店
国酒礼宾(北京)收藏品有限公司	国酒礼宾收藏品
玉林市玉州区尚语服装店	尚语服装店
清河县阳泽服装店	阳泽服装店
泉州一平米贸易有限公司	一平米
北京王匙开锁服务有限公司	王匙
北京修齐治平酒业有限公司	修齐治平
昆明市五华区路遥珠宝首饰店	路遥珠宝首饰店
草法堂（广州）生物科技有限公司	草法堂
乐山市市中区寻味乡野食品经营部	寻味乡野
深圳市雅美怡服饰贸易有限公司	雅美怡
菏泽迈德网络传媒有限公司	迈德网络传媒
****	****
嘉兴绫致服饰有限公司	绫致
栖景酒店管理（上海）有限公司	栖景
山城区青梨同城生活工作室	青梨同城生活工作室
喀左县坤都营子乡新绿州生态家庭农场	喀左县坤都营子乡新绿州生态家庭农场
屏南县宅家等服装店	宅家等服装店
石狮市维云聚服装商行	维云聚商行
上海瘦电闪生物科技发展有限公司	瘦电闪
哈尔滨轩昊科技有限公司	轩昊
糖友饱饱（杭州）健康食品有限公司	糖友饱饱
佛山市禅城区火钳刘明文化传媒工作室	火钳刘明工作室
福州道玄阁贸易有限公司	道玄阁
厦门效效网络科技有限公司	效效
广州千豆汇贸易有限公司	千豆汇
重庆大兵网络科技有限公司	大兵
四会市翠山水珠宝店	翠山水珠宝店
湖南冠琪文化传播有限公司	冠琪
广州市万言草商贸有限公司	万言草
拼也（成都）网络科技有限公司	拼也
沭阳县海蓝蓝商贸有限公司	海蓝蓝
北屯市新原养蜂农民专业合作社	市新原养蜂农民专业合作社
江西省荣乐农业开发有限公司	荣乐
南阳玉泽秀苑珠宝有限公司	玉泽秀苑珠宝
陕西君乐健康管理有限公司	君乐
镇平县元一珠宝工作室	元一珠宝工作室
深圳市文锋网络科技有限公司	文锋
四川全易通品牌管理有限公司	全易通品牌
轻食兔食品(上海)有限公司	轻食兔
北京英皓开拓文化发展有限公司	英皓开拓
罗城仫佬族自治县雅兴服装店	雅兴服装店
苏州工业园区苏茶网络科技有限公司	苏州工业园区苏茶
平邑县珍珍食品经营部	珍珍
宜兴市丁蜀镇艺壶名砂紫砂店	丁蜀镇艺壶名砂紫砂店
莆田振来贸易有限公司	振来
徐州深宏达网络科技有限公司	深宏达
河北百城家政服务有限公司	百城
中山市心好电器有限公司	心好
湖北德支顺专用汽车有限公司	德支顺专用汽车
连云港安诺贸易有限公司	安诺
曲靖惠卡邦科技有限公司	惠卡邦
广州飞凌电子商务有限公司	飞凌
庄浪县域起土特产批发零售店	域起土特产零售店
仙游县度尾维尼服装贸易商行	度尾维尼贸易商行
广州泌茶坊茶叶商行	泌茶坊茶叶商行
深圳市珠穆朗玛品质生态管理有限公司	珠穆朗玛品质生态
杭州美卡电子商务有限公司	美卡
义乌市凌恒电子商务商行	凌恒商行
四会市璎珞珠宝店	璎珞珠宝店
宁夏盐池县光合堂农牧发展有限公司	光合堂农牧
遵义安酒销售有限公司	安酒
聊城市茌平区启明电子科技经营中心	区启明经营
苏州灵灵壹智能科技有限公司	灵灵壹智能
北京天地和合国际贸易有限公司	天地和合
海口曼戈电子商务有限公司	曼戈
深圳汉盛名酱酒业有限公司	汉盛名酱
湖南钧扬网络技术有限公司	钧扬
长沙轩唐文化传播有限公司	轩唐
长沙米游网络科技有限公司	米游
沭阳县新河镇九天之上花卉经营部	新河镇九天之上花卉
西安市雁塔区创意网络工作室	工作室
三明市三国未来贸易有限公司	三国未来
绍兴蜂鸣信息技术有限公司	蜂鸣
北京化大阳光科技有限责任公司	化大
河南恒成安防器材有限公司	恒成安防
黛眉商贸（上海）有限责任公司	黛眉
深圳市创选电子商务科技有限公司	创选
上海巨海企业管理顾问有限公司	巨海
郑州市管城回族区瀚文日化商行	管城回族区瀚文商行
德州中瑞土工材料工程有限公司	中瑞土工
仙游县大济传承缘工艺品店	大济传承缘工艺品店
焦作鑫鼎嘉贸易有限公司	鑫鼎嘉
合肥市包河区港素服装商行	港素商行
即墨区嘉利华商贸店	区嘉利华店
巩义市芝田小龙农副产品商店	芝田小龙农副产品商店
云阳县渝子楠电子商务中心	渝子楠
北京曙光书阁图书有限公司	曙光书阁图书
杭州友话好说教育科技有限公司	友话好说
郫都区诗漫文化工作室	诗漫工作室
惠州市惠阳区淡水墨明飞百货店	淡水墨明飞百货店
合肥经济技术开发区妍丽雅服装店	经济技术开发区妍丽雅服装店
北京十八般科技有限公司	十八般
瑞丽市淼莉珠宝店	淼莉珠宝店
杭州臻轩科技有限公司	臻轩
泉州永春烨睦荣日用品有限公司	烨睦荣日用品
重庆蜀牛知商贸有限公司	蜀牛知
防城港班苏里乐器贸易有限公司	班苏里
北京又见一心网络文化有限公司	又见一心
扶沟县海艳商贸行	海艳行
惠安县敬创贸易商行	敬创贸易商行
杭州妆集电子商务有限公司	妆集
曲阳县汉博雕塑有限公司	汉博雕塑
温州市浙海清洁工程有限公司	浙海清洁
蠡县大策服饰店	大策服饰店
烟台龙诺商贸有限公司	龙诺
孝昌县睿程百货店	睿程百货店
天津乐道安居室内净化有限公司	乐道室内净化
上海乐途实业发展股份有限公司	乐途股份
含山县运漕镇小卫砂锅米线店	运漕镇小卫砂锅米线店
南阳玉之鸿珠宝有限公司	玉之鸿珠宝
鸡东县凡一寝具	凡一寝具
深圳市麦凯莱科技有限公司	麦凯莱
安徽省华信生物药业股份有限公司	华信股份
河南顺尔和商贸有限公司	顺尔和
沈阳市沈河区紫蓥布艺家居生活馆	紫蓥布艺家居生活
变道科技(广州)有限公司	变道
临海市玉明电子商务商行	玉明商行
献县思翔箱包店	思翔箱包店
济南万泰装潢设计有限公司	万泰
洞口县石江镇黄屋寨清哥蜂场	石江镇黄屋寨清哥蜂场
深圳市唯快科技有限公司	唯快
西安市莲湖区长安外传商贸行	外传行
河北海峰电子科技有限公司	海峰
杭州莲心电子商务有限公司	莲心
山西小薇科技有限公司	小薇
甄盛典藏（山东）文化传媒有限公司	甄盛典藏
礼泉中贸发农产品商行	中贸发农产品商行
广州市天河区林和九圆财务咨询服务商行	林和九圆服务商行
新疆伊庄电子商务有限公司	伊庄
北京皓元瑞盛商贸有限公司	皓元瑞盛
成华区龙讯手机店	龙讯手机店
亳州市一号宣言健康产业有限公司	一号宣言产业
山西慧虎健康科技有限公司	慧虎
江西车仆实业有限公司	车仆
福州市鼓楼区百文斋书店	百文斋书店
河北顺元生物科技有限公司	顺元
连云港多耀食品有限公司	多耀
焦作市解放区工业路宇友通讯器材部	路宇友通讯器材
重庆一点雨心科技有限公司	一点雨心
朝阳县大山苗圃	大山苗圃
石狮市飒虎服装商行	飒虎商行
揭阳市榕城区黄涛电子商务商行	黄涛商行
贵州守如一匠酒业有限公司	守如一匠
贵阳市南明区花其轩百货经营部	花其轩百货
杭州乐通达网络有限公司	乐通达
沧州博兰商贸有限公司	博兰
江西会昌杰菲讯贸易有限公司	杰菲讯
深圳市欧依澜电子商务有限公司	欧依澜
封丘县乐一百货店	乐一百货店
尚品京纪人（北京）技术推广有限公司	尚品京纪人技术推广
五常市季英俊水稻种植专业合作社	季英俊水稻种植专业合作社
深圳石头城科技有限公司	石头城
巴东县陈兹方铺子	陈兹方铺子
江华瑶族自治县瑶优生态农业发展有限公司	瑶优生态农业
东莞市生美健康科技有限公司	生美
杭州千尺云科技有限公司	千尺云
贵州民族酒业（集团）销售有限公司	民族
武威星火网络科技有限公司	星火
湖北成就一生科技有限公司	成就一生
应城读睡文化传媒有限公司	读睡
上海红鹿生物工程有限公司	红鹿
长沙佳希生物科技有限公司	佳希
仁寿县鸿韵服装店	鸿韵服装店
合肥领迅喷码科技有限公司	领迅喷码
沈阳艾唯西商贸有限公司	艾唯西
吉林北大荒都市农业股份有限公司	北大荒都市股份
天成易讯（天津）科技有限公司	天成易讯
广州新诺生物科技有限公司	新诺
合肥封侯印商贸有限公司	封侯印
寿光市佰优电子商务有限公司	佰优
莆田乐檬贸易有限公司	乐檬
福州江边鸟网络科技有限公司	江边鸟
北京华夏珍宝博物馆	华夏珍宝博物馆
厦门好印像数码科技有限公司	好印像数码科技
福建省正风雅声茶叶有限公司	正风雅声茶叶
旭封伟业（北京）科技有限公司	旭封伟业
深圳市爆亿单贸易有限公司	爆亿单
济南景森生物技术有限公司	景森
和田市琢见玉原创工作室	琢见玉原创工作室
永定区翼单志百货店	翼单志百货店
济南槐荫阳广企业信息咨询	槐荫阳广
芝罘区光惠日用百货店	光惠日用百货店
廊坊市和合知诚文化传媒有限公司	和合知诚
西安星炬力文化传媒有限公司	星炬力
广西北海绿生阁园艺有限公司	广西北海绿生阁园艺
盘古盈时科技（深圳）有限公司	盘古盈时
四会市翠琅堂珠宝店	翠琅堂珠宝店
东海县石榴街道陈掌柜水晶商行	石榴街道陈掌柜水晶商行
四川环上科技有限公司	环上
北京深知识动力科技有限公司	深知识动力
义乌市鼎妮电子商务商行	鼎妮商行
昌邑市奎聚街道雨辰小百货店	奎聚街道雨辰小百货店
黄岛区妙坦威商贸店	妙坦威店
开封鼎一网络科技有限公司	鼎一
浙江浩天中创贸易有限公司	浩天中创
石家庄悦物容欣商贸有限公司	悦物容欣
东海县百玺珠宝有限公司	百玺珠宝
河北沃辉供应链管理有限公司	沃辉供应链
京山千依朵电子商务有限公司	千依朵
扬州微布坊文化传媒发展有限公司	微布坊
瑞金市九堡镇九堡圩电商服务中心	九堡镇九堡圩电商
武汉早起之星电子商务有限公司	早起之星
广州市卜卜贝家居饰品有限公司	卜卜贝家居饰品
广州威荣服饰有限公司	威荣
阳信县河流镇博学图书店	河流镇博学图书店
重庆城觅文化传播有限公司	城觅
北京林兴画院有限公司	林兴画院
南昌亚曼茶业有限公司	亚曼茶业
广州鸾莺贸易有限公司	鸾莺
泉州市大麦电子商务有限公司	大麦
广州印象贸易有限公司	印象
泗水县金庄鑫鑫电子商务服务中心	金庄鑫鑫
常熟市莫城街道楚岚服装商行	莫城街道楚岚商行
温县波哥日用百货店	波哥日用百货店
天津人民美术出版社有限公司	人民美术出版社
福州市鼓楼区近相服装商行	近相商行
上海辰珊文化传播有限公司	辰珊
山东沐淘网络科技有限公司	沐淘
义乌市众月百货商行	众月百货商行
海宁市许村镇铂瑟服装厂	许村镇铂瑟服装厂
双江森工林业咨询服务中心	双江森工林业
呵护宝宝（深圳）科技有限公司	呵护宝宝
陕西北山生物科技有限公司	北山
福建宏熙农业发展有限公司	宏熙
诸暨市匠星坊针织有限公司	匠星坊
义乌市岳翔贸易商行	岳翔贸易商行
瑞丽市姐告缘信珠宝柜	姐告缘信珠宝柜
江西专墅建筑设计有限公司	专墅
深圳市新司南科技有限公司	新司南
武夷山响喝茶业有限公司	响喝茶业
郴州市一乔服饰有限公司	一乔
深圳市永铠日用品有限公司	永铠日用品
大同市地成农特产商贸有限公司	地成农特产
云梦县新视野服饰店	新视野服饰店
绍兴市呵护成长贸易有限公司	呵护成长
武汉富汇森科技发展有限公司	富汇森
山东冠县阳光交通设施有限公司	交通设施
武汉普莱格医药生物科技有限公司	普莱格医药
邓州市张晖副食店	张晖副食店
云梦县朱青珍服饰店	朱青珍服饰店
烟台一餐一乐餐饮管理有限公司	一餐一乐
偏关县鑫悦好粮	鑫悦好粮
武汉傲天广达科技有限公司	傲天广达
石狮市名旭同创贸易有限公司	名旭同创
泉州市锐恩商贸有限公司	锐恩
沭阳县梦溪小区朝雨百货店	梦溪小区朝雨百货店
合肥勒耀商贸有限公司	勒耀
杭州其乐融融科技有限公司	其乐融融
安徽享搜电子商务有限公司	享搜
福建今时文化传播有限公司	今时
菏泽开发区书广服装店	开发区书广服装店
北京周莹雅学文化传媒有限公司	周莹雅学
高新区丽荷诗商贸部	丽荷诗
广州慕泓网络科技有限公司	慕泓
苏州文视文化传媒有限公司	文视
河南闪投网络科技有限公司	闪投
南宁市江南区云荣水果摊	区云荣水果摊
榆林市高新区山谷子农特产经销部	山谷子农特产经销部
重庆双水井网络科技有限公司	双水井
平湖市曹桥街道阿陆网店	曹桥街道阿陆网店
青岛纯品科技有限公司	纯品
上海普行文化传播有限公司	普行
苏州共创方程式企业管理有限公司	共创方程式
天朝上品酒业（贵州）有限公司	天朝上品
咪咕动漫有限公司	咪咕动漫
古田县江盛农产品经营部	江盛农产品
南宁小棕熊文化传媒有限公司	小棕熊
海宁市海昌思诚贸易商行	海昌思诚贸易商行
绍兴市沐畅贸易有限公司	沐畅
广州千翼生物科技有限公司	千翼
惠州市宏业仪器有限公司	宏业
扬州梯子教育科技发展有限公司	梯子
仙游京翰贸易有限公司	京翰
深圳市洋客数码科技有限公司	洋客数码科技
石狮市戴彬彬服装商行	戴彬彬商行
湖北省亿佳翻译咨询服务有限公司	亿佳
小熊时代(北京)科技发展有限公司	小熊时代
沈阳市铁西区诚晟日用百货经营部	诚晟日用百货
浙江仁合生态农业发展有限公司	仁合生态农业
兴国僚溪文化传播有限公司	僚溪
莆田市觉家贸易有限公司	觉家
中农科惠（北京）科技有限公司	中农科惠
厦门普云文化传播有限公司	普云
赫章小敏姐的精品店	小敏姐的精品店
陕西博睿淼电子商务有限公司	博睿淼
平乐县四炮食品店	四炮食品店
温州迅维网络科技有限公司	迅维
广东趣库存科技有限公司	趣库存
陕西美云医药有限公司	美云医药
盐山瑞通钢管有限公司	盐山瑞通钢管
桐乡市酷锐服饰有限公司	酷锐
永定区遇上阿萌宠物用品店	遇上阿萌宠物用品店
岢岚县新农人电子商务有限公司	新农人
莆田市致派贸易有限公司	致派
贵州省仁怀市云锐酒业销售有限公司	云锐
湘潭县久客康食品有限公司	久客康
惠州市惠城区法拉敏百货商行	法拉敏百货商行
鼎湖区锄禾商行	锄禾商行
淮北智触网络科技有限公司	智触
吉林省鸿盛吉商贸有限公司	鸿盛吉
苏州扶苏不说传媒有限公司	扶苏不说
泰州市企城不锈钢制品有限公司	企城不锈钢
北流市康全生物科技有限公司	康全
临沂市兰山区优顿食品商行	优顿商行
广州玄博文化传播有限公司	玄博
连云港臻乐鲜商贸有限公司	臻乐鲜
深圳市古传文化传播有限公司	古传
陕西海瑞电器有限公司	海瑞
岫岩满族自治县美宣文言珠宝店	美宣文言珠宝店
杭州映月书房电子商务有限公司	映月书房
珲春市亿亨参茸土特产店	亿亨参茸土特产店
栖霞市大侠商贸经营部	大侠
临沂商城一米居日用百货商行	一米居日用百货商行
阳信云飞建筑机械设备有限公司	云飞
潍坊迈博网络信息技术有限公司	迈博
北京正易门文化传播有限公司	正易门
普宁市流沙丝音乐器店	流沙丝音乐器店
上海佰医合贸易有限公司	佰医合
鄂州市益健生物科技有限公司	益健
广州市天河区棠下丹妮贸易商行	棠下丹妮贸易商行
厦门达零实业有限公司	达零
南宫市璐姐家服装店	璐姐家服装店
上海茶歇商贸有限公司	茶歇
山西药茶科技有限公司	药茶
漳县陇右宝中药材土特产商店	陇右宝中药材土特产商店
延吉市奥利给食品经销中心	奥利给经销
武汉斯普利康电子商务有限公司	斯普利康
西安市灞桥区松松籽精品服饰店	松松籽精品服饰店
艾姆希恩（绍兴）文化传媒有限公司	艾姆希恩
杭州乔凡服装有限公司	乔凡
屏南县宁致远贸易商行	宁致远贸易商行
天台天丞服装店	天丞服装店
山西静若山农业综合开发有限责任公司	静若山综合
兰山区茗雅花卉店	茗雅花卉店
南通乐尔梦纺织品有限公司	乐尔梦纺织品
上海暖林实业有限公司	暖林
南京希悦电子商务有限公司	希悦
仙游果子电子商务有限公司	果子
成都市府上府食品有限公司	府上府
河南省跨境电子商务有限公司	跨境
上海萌云实业有限公司	萌云
合肥瑞驰门电子商务有限公司	瑞驰门
邳州市好的服装店	好的服装店
杨凌一棵树农业有限公司	杨凌一棵树
湖北购优科技有限公司	购优
西安汉鲸影视文化传媒有限公司	汉鲸影视文化
滨州翼展传媒有限公司	翼展
天门市勇勇服装店	勇勇服装店
惠州友帮大药房连锁有限公司	友帮大连锁
北京木口科技有限公司	木口
青岛孚美食品有限公司	孚美
江西犁程科技机械有限公司	犁程
武汉市洪山区康普佳电器经营部	康普佳
黄岛区硕嘉德商贸店	硕嘉德店
泗洪县首尔公主服装店	首尔公主服装店
重庆融炫科技发展有限公司	融炫
邓州市美之梦商贸有限公司	美之梦
温州哈博科技有限公司	哈博
瑞丽市星忆珠宝有限公司	星忆珠宝
临沂市兰山区二哥百货商贸中心	二哥百货
杭州乾坤服饰有限公司	乾坤
鱼台县鱼贝贝宠物店	鱼贝贝宠物店
广东顺德脊椎宝健康管理有限公司	脊椎宝
翼城县黄小六电子商务有限公司	黄小六
莆田市城厢区皇典名茶店	皇典名茶店
屯留县览众广告有限公司	屯留县览众
广州星梦工场电子商务有限公司	星梦工场
海宁市海昌依远贸易商行	海昌依远贸易商行
苏州欧码标识科技有限公司	欧码标识
上海亲恬贸易有限公司	亲恬
陕西兴农乐商业运营管理有限公司	兴农乐
广州就简品牌管理有限公司	就简品牌
陕西新源源涂料有限公司	新源源
汇世华运（深圳）文化传媒有限公司	汇世华运
锦江区三生家具经营部	三生家具
莆田市荔城区东堂百货商行	东堂百货商行
云南捉渔网络科技有限公司	捉渔
济南凡梦文化传媒有限公司	凡梦
义乌市紫陌飞絮电子商务有限公司	紫陌飞絮
西咸新区沣东新城贵福俐百分店	西咸新区沣东贵福俐百分店
中务企业管理咨询（武汉）有限公司	中务
武汉云上于天电子商务有限公司	云上于天
北京卓艺中天文物文化发展有限公司	卓艺中天文物
邵武市集梦日用品商行	集梦日用品商行
石首市帝式电子商务有限公司	帝式
介休市说鸽赛鸽用品经营部	说鸽赛鸽用品
偏关欣海网络科技有限公司	欣海
固始县唐味土特产品	唐味土特产品
生态美家（北京）环境科技有限公司	生态美家环境
桐乡市梧桐卓继宇文贸易商行	梧桐卓继宇文贸易商行
广西容县木木三农业有限公司	木木三
湖北飞福商贸有限公司	飞福
温州市龙湾状元洁妍电子商务商行	状元洁妍商行
无锡市泽嘉科技有限公司	泽嘉
河北厚昌网络技术有限公司	厚昌
辽源市西安区木廉优品服饰店	木廉优品服饰店
东兴市其哥贸易商行	其哥贸易商行
上海美哈生物科技发展有限公司	美哈
贵阳市南明区蓝色咖啡馆	蓝色咖啡馆
桐乡市濮院酷伦服装网店	濮院酷伦服装网店
合肥市蜀山区阅趣图书网店	阅趣图书网店
沈阳美逸文化传播有限公司	美逸
西安市高新区清吉海日用品商行	清吉海日用品商行
汝州市舒美百货店	舒美百货店
正和文化投资发展（深圳）有限公司	正和
河南一点网聚网络科技有限公司	一点网聚
绍兴森亿格科技有限公司	森亿格
上海戎裕贸易有限公司	戎裕
贵州摘冠酒业有限公司	摘冠
威海临港经济技术开发区良榛农场	临港经济技术开发区良榛农场
惠州市惠城区西女眉百货店	西女眉百货店
瑞丽市墨奈珠宝店	墨奈珠宝店
仁怀市茅台镇翁林散酒经营部	茅台镇翁林散酒
梁山欢喜购电子商务有限公司	欢喜购
惠州市恒佳安防器材有限公司	恒佳安防
三门峡市湖滨区腾辉农副产品店	腾辉农副产品店
深圳太太生物科技有限公司	太太
东兴市铭儒特产商行	铭儒特产商行
阳春市潭水镇岭南四哥农产品店	潭水镇岭南四哥农产品店
沈阳锡安商贸有限公司	锡安
沙河口区惠爱花坊	惠爱花坊
青岛博华俊奇服饰有限公司	博华俊奇
新邵县代客宝网络服务有限公司	代客宝
南昌洪庆科技有限公司	洪庆
宿豫区娜斯佳食品商行	娜斯佳商行
泉州南朋友信息科技有限公司	南朋友
唐山风山渐网络科技有限公司	唐山风山渐
郑州盛轩电器有限公司	盛轩
洛阳傲宁商贸有限公司	傲宁
莆田市涵江区静思商务信息咨询工作室	静思工作室
山东街景智能制造科技股份有限公司	街景智能
桐乡大河马网络科技有限公司	大河马
广州名渠优品科技有限公司	名渠优品
神池县石记源食品有限公司	石记源
惠州大亚湾唯尚佳饰品店	大亚湾唯尚佳饰品店
安陆市丁鸿生家居用品经营部	丁鸿生
四会市友福玉器店	友福玉器店
杭州磨铁文化创意有限公司	磨铁
深圳市淘品源头科技有限公司	淘品源头
广州车早茶汽车销售有限公司	车早茶
无锡易正贸易有限公司	易正
温州市鹿城区豆趣百货店	豆趣百货店
长春市上鲸商务服务有限公司	上鲸商务
吴兴织里朵阳童装商行	织里朵阳童装商行
盘锦水玲珑文化传媒有限公司	水玲珑
唯尚品百货商场（杭州）淘宝店	唯尚品百货商场淘宝店
静宁县成纪鸿源果业农民专业合作社	成纪鸿源果业农民专业合作社
赣榆区海头镇渔乡味水产品经营部	区海头镇渔乡味
南京市栖霞区张飞百货店	张飞百货店
北京洋洋兔文化发展有限责任公司	洋洋兔
合肥融方教育投资发展有限公司	融方
澳妆（上海）国际贸易有限公司	澳妆
北京佳音旗舰科技发展有限公司	佳音旗舰
广东壹品电子商务有限公司	壹品
沈阳青沐环保科技有限公司	青沐环保
北京伴鱼智学科技有限公司	伴鱼智学
清河县米月贸易有限公司	米月
深圳市龙岗区优品手机销售中心	优品手机
福州市鼓楼区绍枫建材经营部	绍枫建材
河南省润米科技有限责任公司	润米
青岛幸福点点网络科技有限公司	幸福点点
广州奇珍电子商务有限公司	奇珍
义乌市恒曼日用品有限公司	恒曼日用品
屏南县旺佳食品商行	旺佳商行
东莞市小邦自动化科技有限公司	小邦
盘锦市辽河口生态经济区石新镇梦想无限网络工作室	辽河口生态经济区石新镇梦想无限工作室
湖南往来文化传媒有限公司	往来
山东世纪宏业汽车销售有限公司	世纪宏业
中承信达（天津）技术股份公司	中承信达
重庆师之航教育科技有限公司	师之航
济宁市泰仁堂商贸有限公司	泰仁堂
佛山妖八电子商务有限公司	妖八
富硒姐姐（辽宁）生物科技有限公司	富硒姐姐
昆山市锦溪镇黄山盛雨茶叶店	锦溪镇盛雨茶叶店
珲春市汇品贸易有限公司	汇品
泉州市谓道文化传媒有限公司	谓道
即墨区途途商贸部	区途途
贵州黔续台酒业有限公司	黔续台
昆明牛角王商贸有限公司	牛角王
沧州市运河区三道阁工艺品经销处	三道阁工艺品经销处
长春市锐途文化传媒有限公司	锐途
天台欧帕汽车用品经营部	欧帕
广州市白云区同和蕲艾养生会所	同和蕲艾养生会所
深圳市缔森科技有限公司	缔森
保定白沟新城勋宫服饰店	白沟勋宫服饰店
天门市毕辉商贸有限公司	毕辉
中盈传媒（辽宁）有限公司	中盈
江苏中豆生物科技集团有限公司	中豆
日照市东港区千尺电子商务服务中心	千尺
永城市龙岗悦诚金蝉养殖	悦诚金蝉养殖
长春市子贺商贸有限公司	子贺
名亮房车（深圳）有限公司	名亮房车
天台江渔百货商行	江渔百货商行
石河子市一点通信息咨询工作室	一点通工作室
银侨（山东）科技发展有限公司	银侨
重庆肖谷文化传媒有限公司	肖谷
即墨市可可之家服饰店	即墨市可可之家服饰店
北京瑞创恒泰科技有限公司	瑞创恒泰
杭州黔优网络科技有限公司	黔优
明乾教育科技（上海）有限公司	明乾
平邑县紫絮飘菱图书店	紫絮飘菱图书店
苍南县壹合茶叶店	壹合茶叶店
昌江区晨曦百货店	晨曦百货店
南京苇韧纺织服饰科技有限公司	苇韧
长春市优智教育信息咨询有限公司	优智
龙井市大姐粮油经销部	大姐粮油经销部
藏宝图（无锡）电子商务有限公司	藏宝图
山西五台山天域农业开发有限公司	五台山天域
苍南贵足商贸有限公司	贵足
绥芬河市向敏食品商店	向敏商店
惠州市智音尚品电子科技有限公司	智音尚品
深圳市龙华区泽程家居用品经营部	泽程
贵州省仁怀市觥筹酱酒销售部	觥筹酱酒销售部
重庆定友网络科技有限公司	定友
罗城仫佬族自治县阿甘水果店	阿甘水果店
上海邦劲电子商务有限公司	邦劲
襄城区极客音乐工作室	极客音乐工作室
垦利区郝家镇聚缘鑫土特产商店	区郝家镇聚缘鑫土特产商店
杭州余杭礼尚美服饰店	礼尚美服饰店
沈阳恒泽农业有限公司	恒泽
屏南县林晟贸易商行	林晟贸易商行
安陆筱媛商贸有限公司	筱媛
上海能辉不锈钢有限公司	能辉不锈钢
济南中耐研磨科技有限公司	中耐研磨
北京万维之道信息技术有限公司	万维之道
福州市台江区中藏文化传播有限公司	中藏
深圳市曼诺诗网络科技有限公司	曼诺诗
河南省图名文化传播有限公司	图名
河北晶峰能源科技有限公司	晶峰
西安市莲湖区一佳惠家烟酒便利店	一佳惠家烟酒便利店
蔻露薇（上海）化妆品有限公司	蔻露薇
杭州奕薇雅服饰有限公司	奕薇雅
历城区集梦运转百货商行	集梦运转百货商行
和么（义乌市）电子商务有限公司	和么
滨海县滨海港镇中老电子商务服务中心	港镇中老
星鼎源（天津）网络技术有限公司	星鼎源
杭州鑫炎雨蓬有限公司	鑫炎雨蓬
临泉县单桥镇郭三农产品经营部	单桥镇郭三农产品
南平市建阳区非烦哥农特产店	区非烦哥农特产店
平和县闽之源味电子商务有限公司	闽之源味
上海美虎电子商务有限责任公司	美虎
宿豫区奢品典藏钟表店	奢品典藏钟表店
金华九位数网络科技有限公司	九位数
山东耐诺思教育咨询有限公司	耐诺思
四川诗漫文化传媒有限公司	诗漫
北京时代众乐琴行有限公司	时代众乐琴行
义乌市源帅电子商务商行	源帅商行
天门市净潭乡纯妮可儿服装店	净潭乡纯妮可儿服装店
双江自治县勐库镇荼画茶行	双江自治县勐库镇荼画茶行
广州宜顺纸品科技有限公司	宜顺纸品
四会市镁玉镗珠宝专柜	镁玉镗珠宝专柜
赤壁鹤彩生活家居商行	鹤彩生活家居商行
宁波妙瑞科技有限公司	妙瑞
武汉奥瀚博电子商务有限公司	奥瀚博
宜兴市湖父镇鲍生泰紫砂艺术馆	湖父镇鲍生泰紫砂艺术馆
和顺县新马杂粮开发有限公司	新马杂粮
四会市丽都玉器店	丽都玉器店
瑞丽市通归珠宝店	通归珠宝店
朔州市平鲁区源生泰电子商务有限公司	源生泰
上海虎联信息科技有限公司	虎联
天津北洋津宜食品有限公司	北洋津宜
广安森兴食品有限公司	森兴
黄岛区凯格辉商贸店	凯格辉店
北京易佳有品电子商务有限公司	易佳有品
海南中达贸易有限公司	中达
山西白龙河农业开发有限公司	白龙河
苏州和是网络科技有限公司	和是
修罗（天津）安防科技有限公司	修罗安防
广东恒金堂医药连锁有限公司	恒医药连锁
晋江市智勇双全贸易有限公司	智勇双全
上海综国之都实业有限公司	综国之都
金牛区多快好省商务信息咨询服务部	多快好省
青岛威奥服饰有限公司	威奥
中途国际旅行社深圳有限公司	中途旅行社
武汉凡东尼建材有限公司	凡东尼建材
江北新区揽亦悦数码电子产品经营部	新区揽亦悦数码电子产品
山西日新昶贸易有限公司	日新昶
沧州暴风靓慧科技有限公司	暴风靓慧
福建省沁石轩文化传媒有限公司	沁石轩
绍兴市越城区峻宇游乐场	峻宇游乐场
永安市燕南街扶晴梅百货商行	燕南街扶晴梅百货商行
电白区茗龟荟水产养殖场	电白区茗龟荟水产养殖场
福建好日子食品有限公司	好日子
郑州市管城回族区波恒百货商行	管城回族区波恒百货商行
陕北霞姐（延安）品牌运营有限公司	陕北霞姐品牌
兰山区阿锋食品商行	阿锋商行
青岛世纪盛美电子商务有限公司	世纪盛美
安徽温尔康药业有限公司	温尔康
西安彩云南山商贸有限公司	彩云
内蒙古堂前燕文化有限公司	堂前燕
西安市长安区惟思乐学书店	惟思乐学书店
深圳市零川科技有限公司	零川
汕头市亮之鼎电子商务有限公司	亮之鼎
湖南金空间装饰工程有限公司	金空间
固安县檀村商贸店	檀村店
北京腰宴餐饮管理有限公司	腰宴
上海鑫桂贸易有限公司	鑫桂
汕头市联顺商贸有限公司	联顺
北京德记红门餐饮管理有限公司	德记红门
广东邓老健康科技有限公司	邓老
缙云县诺森贸易有限公司	诺森
巩义市方正机械厂	机械厂
北京边走边淘电子商务有限公司	边走边淘
常熟花花草草电子商务有限公司	花花草草
湘阴秋旭服饰经营部	秋旭
桂平市麻垌镇小慕容农副产品经营部	麻垌镇小慕容农副产品
吴江区松陵镇扶苏家水果商行	区松陵镇扶苏家水果商行
泉州市哥也爱电子商务有限公司	哥也爱
枣阳市乡间小燕子综合经营部	乡间小燕子综合
义乌市劲腾电子商务有限公司	劲腾
深圳市完人生物科技有限公司	完人
河南文之墨电子科技有限公司	文之墨
贵州省仁怀市茅台镇至尊台酒业有限公司	茅台镇至尊台
河南添美园林景观设计有限公司	添美园林景观
海南智信体育用品有限公司	智信
昆山千灯镇南野智能科技店	千灯镇南野智能店
深圳市名诺教育科技发展有限公司	名诺
御米（厦门）进出口股份有限公司	御米股份
广州市白云区江高美啦美甲店	江高美啦美甲店
瑞丽市增泽农副产品店	增泽农副产品店
深圳九九购电子商务有限公司	九九购
深圳市初末电子商务有限公司	初末
长沙高新技术产业开发区煦锦静轩信息技术服务工作室	高新技术产业开发区煦锦静轩工作室
河北飞宇网络科技有限公司	飞宇
丹阳市侠客眼镜有限公司	侠客眼镜
亳州市荣禾文化传播有限责任公司	荣禾
瑞丽市乾宝贸易有限公司	乾宝
合肥帮宝生物科技有限公司	帮宝
四川巧夫人食品有限公司	巧夫人
南阳市宛城区新志土特产小铺	新志土特产小铺
大连合泽电子商务有限公司	合泽
东莞市国潮文化传媒有限公司	国潮
贵州名瑞园生态农业发展有限公司	名瑞园生态农业
疏勒县小胡电动车维修店	小胡电动车维修店
日照市岚山区汤姆水产行	区汤姆水产行
许焱鑫	许焱鑫
诸暨海默电子商务有限公司	海默
温州豪能光学眼镜有限公司	豪能光学眼镜
鄂托克旗江艳牧家食品店	江艳牧家食品店
宝宝巴士（福州）电子商务有限公司	宝宝巴士
厦门富居山丘贸易有限公司思明分公司	富居山丘
固安实达衡器销售有限公司	实达衡器
瑞丽市垒玉珠宝有限公司	垒玉珠宝
合肥秒动传媒有限公司	秒动
广州粤秀电子商务有限公司	粤秀
武汉天宝享网络科技有限公司	天宝享
东海县钟意阁珠宝商行	钟意阁珠宝商行
阜阳量扩网络科技有限公司	量扩
大同市平城区臻以林干果店	平臻以林干果店
大理市湾桥镇白蛮工艺品店	湾桥镇白蛮工艺品店
北京五彩小牛酒业科技有限公司	五彩小牛
智诚盈科（北京）科技有限公司	智诚盈科
广州金耳勺采耳健康管理有限公司	金耳勺采耳
义乌锦鲤企业管理咨询有限公司	锦鲤
衢州市柯城名润食品小作坊	名润小作坊
南靖县追兰兰花种植场	追兰兰花种植场
石狮通少电子商务有限公司	通少
南京今风细雨计算机有限公司	今风细雨
北京五鱼格科技有限公司	五鱼格
惠州市昌盛居房地产代理有限公司	昌盛居房地产
佛山开彩科技有限公司	开彩
南京骏禾通商贸有限公司	骏禾通
义乌市骏烨服装有限公司	骏烨
抚州市东乡区鲶鱼煮粉店	区鲶鱼煮粉店
河南客串信息科技有限公司	客串
厦门市星语姿化妆品有限公司	星语姿
德州瑞鑫生物科技有限公司	瑞鑫
遵化市崔家庄乡飞飞工艺品加工厂	崔家庄乡飞飞工艺品加工厂
上海伊含实业有限公司	伊含
安徽飞叶商贸有限公司	飞叶
东莞市赶风网络科技有限公司	赶风
深圳小阔科技有限公司	小阔
天津天润装饰装修有限公司	天润
泉州市雷鸟贸易有限公司	雷鸟
深圳市龙华区大浪街道大柚子商行	大浪街道大柚子商行
徐州丰禾回转支承制造股份有限公司	丰禾回转支承股份
邓州市裕胜商贸有限公司	裕胜
英德市禾土农业科技有限公司	禾土
北京宸宇永盛建筑装饰工程有限公司	宸宇永盛
高新区枫桥格丽诗日用品经营部	枫桥格丽诗日用品
陕西东众实业有限公司	东众
南城县森尼服装经营部	森尼
河南擎天云生物科技有限公司	擎天云
四季沐歌科技集团有限公司	四季沐歌
义乌市志平化妆品有限公司	志平
讯通（孝感）通讯有限公司	讯通
成都书声科技有限公司	书声
四会市谨青珠宝店	谨青珠宝店
深圳市英利标准检测技术有限公司	英利标准
泽暄盛世（北京）贸易有限公司	泽暄盛世
平遥陶日包装种子站	陶日包装种子站
长沙诗茵信息科技有限公司	诗茵
武汉希颜互成电子商务有限公司	希颜互成
乐清市雁荡梓珩服装网店	雁荡梓珩服装网店
合肥市蜀山区黑鲷百货经营部	黑鲷百货
张家港欧码喷码电子有限公司	欧码喷码
尤溪县一心茶叶店	一心茶叶店
金丝雀影视文化传媒（山东）有限公司	金丝雀影视文化
霞浦县奇洛日用品经营部	奇洛日用品
平凉爽歪猫网络科技有限公司	平凉爽歪猫
柘城县锦觅商贸工作室	锦觅工作室
云南邓氏茶业有限公司	邓氏茶业
晋江市永和镇超级牛服饰店	永和镇超级牛服饰店
会昌魅惠丹贸易有限公司	魅惠丹
来安县韩郢网络科技有限公司	韩郢
慧爱家庭服务（上海）有限公司	慧爱家庭
金华市激石电子商务有限公司	激石
飞竹（上海）信息科技有限公司	飞竹
衡南龙运种养专业合作社	龙运种养专业合作社
上海塑唯新材料有限公司	塑唯新
杭州晨之美商贸有限公司	晨之美
杭州聚浪互联网科技有限公司	聚浪
邢台市萨动商贸有限公司	萨动
南宁市青秀区惠彬食品经营部	惠彬
富平县柿之恋农业发展有限公司	柿之恋
厦门市西酌生物科技有限公司	西酌
延川县曹二英农业科技有限责任公司	曹二英
北京共享利他教育科技有限公司	共享利他
四会市吕布珠宝专柜	吕布珠宝专柜
深圳市蛟腾表业有限公司	蛟腾表业
西安衍科电子商务有限公司	衍科
尉氏县超雷百货店	超雷百货店
河南湘秦网络科技有限公司	湘秦
上海翼岬影视传媒有限公司	翼岬影视
大丰区帮办信息服务站	区帮办服务站
江阴市澄江街道米粒红人互联网电子商务工作室	街道米粒红人工作室
广州市简尚贸易有限公司	简尚
南京零点奇煜网络科技有限公司	零点奇煜
深圳市风生水起商贸有限公司	风生水起
瑞丽市鼎茂珠宝有限公司	鼎茂珠宝
北京恒发嘉业展览展示有限公司	恒发嘉业展览展示
哈尔滨市思睿电子商务有限公司	思睿
兴安邦包装机械（山东）有限公司	邦包装
北京悦来从心文化有限公司	悦来从心
温州市国君鞋业有限公司	国君
邳州市阿军家卫生用品店	阿军家卫生用品店
太原市伊顿教育科技有限公司	伊顿
杭州万双鑫宇贸易有限公司	万双鑫宇
港闸区老苏家具经营部	老苏家具
四川蓝漂日用品有限公司	蓝漂日用品
济南牛角镇电子商务有限公司	牛角镇
深圳市茜仔巴巴商务有限公司	茜仔巴巴商务
张家界山水旅游服务有限公司	山水
神池县源瑞农产品开发有限公司	源瑞农产品
昔阳县田客农牧专业合作社	田客农牧专业合作社
金牛区公元网络工作室	公元工作室
饶平县千弘利陶瓷店	千弘利店
深圳新素力科技有限公司	新素力
火人京创（北京）医疗器材有限公司	火人京创
北京睿泽澜庭科贸有限公司	睿泽澜庭科贸
大连可爱思跨境电商有限公司	可爱思跨境电商
西安美信信泽品牌管理有限公司	美信信泽品牌
沭阳县耿圩镇耕读传家农资经营部	耿圩镇耕读传家农资
大道网络科技（佛山）有限公司	大道
深圳黎光科技有限公司	黎光
衡南县云集格尔麦服装设计工作室	云集格尔麦服装设计工作室
广西渔乐在线科技有限公司	渔乐在线
上海仁宇网络科技有限公司	仁宇
广州钞盟网络科技有限公司	钞盟
北京强科达科技有限公司	强科达
莆田市秀屿区东庄智强强百货店	东庄智强强百货店
高州市高凉臻品农产品店	高凉臻品农产品店
杭州市西湖区马悦兮服装百货店	马悦兮百货店
东莞市长安惠品服装店	惠品服装店
河南点多多企业管理咨询有限公司	点多多
成华区成玉欣服装经营部	成玉欣
厦门姿致健康科技有限公司	姿致
沈阳市铁西区磁戒家庭婚姻心理指导部	磁戒家庭婚姻心理指导
指尖飞舞（深圳）电子商务有限公司	指尖飞舞
上海启哲电子商务有限公司	启哲
广州珊珊钟表有限公司	珊珊钟表
聊城市保祺电子商务有限公司	保祺
北京睿洁环保科技有限公司	睿洁环保
聚量（重庆）文化传媒有限公司	聚量
利辛县双喜堂棉被家纺定制加工坊	双喜堂棉被家纺坊
湖南博雅礼品有限公司	博雅礼品
西安玛宸网络科技有限公司	玛宸
广州市旭峰优品科技有限公司	旭峰优品
安溪县城厢笑盈盈家具店	笑盈盈家具店
潍坊关爱商贸有限公司	关爱
仙桃市一二三网络科技有限公司	一二三
亳州市谯城区锦伊服饰店	锦伊服饰店
上海树艺文化传播有限公司	树艺
上海蒂妮化妆品有限公司	蒂妮
东莞好又来网络科技有限公司	好又来
海宁市海洲街道川屿贸易商行	海洲街道川屿贸易商行
杭州星智胜科技有限公司	星智胜
深圳市正欣园艺科技有限公司	正欣园艺
海南纯玩客旅游服务有限公司	纯玩客
天津银座聊车信息技术有限公司	银座聊车
蜜康达健康管理（东莞）有限公司	蜜康达
义乌语小耳日用百货经营部	语小耳日用百货
北京哈森电子科技有限公司	哈森
上海三枪(集团)有限公司	三枪
西安经济技术开发区农夫园蔬果店	经济技术开发区农夫园蔬果店
青岛铖铭物资有限公司	铖铭物资
赣榆区海头镇君强水产品经营部	区海头镇君强
山西中藜电子商务有限责任公司	中藜
滕州所在电子商务有限公司	所在
山东锦鲤诺康生物科技有限公司	锦鲤诺康
北京芳迪服饰有限公司	芳迪
太原农合盛农业开发有限公司	农合盛
兰山区怡婕日用百货店	怡婕日用百货店
沈阳吉祥三宝医药生物科技有限公司	吉祥三宝医药
苏州宝玛丹顿服饰有限公司	宝玛丹顿
保定闯荡商贸有限公司	闯荡
陕西益农食品有限公司	益农
成华区白智鸽商贸部	白智鸽
巢湖市成蹊天恒电子商务有限责任公司	成蹊天恒
青岛丹尼尔顿电子商务有限公司	丹尼尔顿
小熊时代（北京）科技发展有限公司	小熊时代
四川华秋哥生态农业有限公司	华秋哥生态农业
陕西聚鑫互联软件科技有限公司	聚鑫互联
山东御时特电动车科技有限公司	御时特电动车
莆田市秀屿区平海青石百货店	平海青石百货店
东阳市横店锦风小七服装店	横店锦风小七服装店
胶州市依韵雪食品商店	依韵雪商店
长葛市嘉阳电脑经营商行	嘉阳电脑经营商行
西安市高新区虹洪美服装店	虹洪美服装店
南昌合舟科技有限公司	合舟
绥化市北林区传祺文化传媒工作室	传祺工作室
北京梦想当然传媒有限公司	梦想当然
安溪县参内罄竹茶叶店	参内罄竹茶叶店
湖南创金经信息科技有限公司	创金经
济南常青藤图书有限公司	常青藤图书
上海滋叻美贸易有限公司	滋叻美
广州倍增企业管理咨询有限公司	倍增
广州叁琳科技有限公司	叁琳
莆田市城厢区勤祥鞋服商行	勤祥鞋服商行
广州市天河区珠吉须弥山水沉香工作室	珠吉须弥山水沉香工作室
灯塔市欣鑫吖服饰店	欣鑫吖服饰店
杭州恋乡电子商务有限公司	恋乡
黄岛区百城惠长百货店	百城惠长百货店
深圳市迪菲妮钟表有限公司	迪菲妮钟表
武汉辰阳生物技术有限公司	辰阳
哈尔滨清江网络科技有限公司	清江
石狮市户派服饰有限公司	户派
合肥舍阜品牌管理有限公司	舍阜品牌
山东路得威工程机械制造有限公司	路得威机械制造
北京弘聚隆商贸有限公司	弘聚隆
大城县丁庄宇桐百货店	丁庄宇桐百货店
罗兰德式（深圳）门窗科技有限公司	罗兰德式门窗
泉州市巨潮鞋业有限公司	巨潮
台州市路桥今儿服饰商行	今儿商行
五常市食谷水稻种植专业合作社	食谷水稻种植专业合作社
山西清高食品股份有限公司	清高股份
胶州市艺夏群网络科技工作室	艺夏群工作室
城阳区锦城鲜水产品店	锦城鲜店
秦皇岛沃尔夫线缆有限公司	沃尔夫线缆
珠海臻玉化妆品有限公司	臻玉
上海微媛网络科技有限公司	微媛
兰山区琳祥百货商店	琳祥百货商店
成华区洛民床上用品商贸部	洛民床上用品
许昌市东城区衣衣不舍服饰商店	衣衣不舍商店
河北亚普汽车零部件有限公司	亚普
东莞巨臣国际贸易有限公司	巨臣
泉州泉港东之吴电子商务服务中心	泉港东之吴
厦门庚耀工贸有限公司	庚耀
西安市莲湖区裕安锁具维修部	锁具维修部
北京创乐家网络科技有限公司	创乐家
北京良物珍品电子商务股份有限公司	良物珍品股份
通化县快大茂镇志强机械电路维修部	快大茂镇志强电路维修部
邵东市宋家塘迈动箱包商行	市宋家塘迈动箱包商行
义乌市健宝城烟具商行	健宝城烟具商行
山西蒲谷香农业科技有限公司	蒲谷香
千慧脑智（杭州）科技有限公司	千慧脑智
上海冀之申电子科技有限公司	冀之申
成都优声科技有限公司	优声
嘉善利东贸易有限公司	利东
郑州享通电子商务有限公司	享通
天台县隆彩百货店	隆彩百货店
上海百特麦电子商务有限公司	百特麦
新疆美棘生物科技有限公司	美棘
莆田市秀屿区平海邻家美依服装店	平海邻家美依服装店
莆田市麦福逊贸易有限公司	麦福逊
泰安开发区惠丰园艺场	开发区惠丰园艺场
陕西帮小农农业科技有限责任公司	帮小农
巫山县祥信锐电子商务有限公司	祥信锐
四川酣道私人定制网络科技有限公司	酣道私人
新乡市红旗区觅美生活超市网店	觅美生活超市网店
邢台沃宇机械制造有限公司	沃宇机械制造
沈阳严选网络科技有限公司	严选
清河县修混贸易商行	修混贸易商行
杭州洪范电子商务有限责任公司	洪范
揭阳小麦科技有限公司	小麦
桐乡市洲泉足雅皮鞋店	洲泉足雅皮鞋店
深圳光明区三晟电子商务中心	区三晟
荆州区农馨超市	农馨超市
深圳市棋桓商贸有限公司	棋桓
德化县陶心缘陶瓷厂	陶心缘陶瓷厂
佛山市南海区里水奇新音响店	里水奇新音响店
河北巨因生物科技有限公司	巨因
浦江县涵美服饰有限公司	涵美
上海奈多智能科技有限公司	奈多智能
瑞安市柳松手机店	柳松手机店
安康邱老头农副产品有限公司	邱老头农副产品
马鞍山星辰网络科技有限公司	星辰
巴南区享福副食超市	享福副食超市
北京鲁班文化发展中心	鲁班
北京易企服信息咨询有限公司	易企服
北京艾乐可国际教育科技有限公司	艾乐可
深圳市聚八方科技有限公司	聚八方
安陆市纯瑞服装店	纯瑞服装店
水磨沟区昆仑路灵尚和美玉器店	昆仑路灵尚和美玉器店
城关区云创优品批发商行	云创优品批发商行
义乌市啸霆电子商务商行	啸霆商行
铭辰企业管理（深圳）有限公司	铭辰
深圳宁深安德科技贸易有限公司	宁深安德
天门洛熙贸易有限公司	洛熙
合肥经济技术开发区林度百货商行	经济技术开发区林度百货商行
广州市子特皮具有限公司	子特皮具
东海县瑶群珠宝商行	瑶群珠宝商行
瑞丽市钱合昌珠宝店	钱合昌珠宝店
滨州市品购网络科技有限公司	品购
北京木子秋水文化发展有限公司	木子秋水
赣州铭钥电子商务有限公司	铭钥
成都智点科技有限公司	智点
深圳万玺食品有限公司	万玺
四会市八零九零珠宝店	八零九零珠宝店
云南高特网络科技有限公司	高特
神农架林区宏怡商贸有限公司	宏怡
金昌谷风堂网络科技有限公司	谷风堂
广州悦她电子商务有限公司	悦她
山西宝山鼎盛科技有限公司	鼎盛
南昌市顿升科技有限公司	顿升
河北万道健生中药科技有限公司	万道健生中药
黄岛区惠可泽商贸店	惠可泽店
全南县小溪土特产店	小溪土特产店
宁波保税区巧可美进出口有限公司	保税区巧可美
晋江市磁灶镇刘辉花店	磁灶镇刘辉花店
安徽樵纪实业发展有限公司	樵纪实业
天津市欧尚寄卖有限公司	欧尚寄卖
瑞丽市艺珏珠宝有限公司	艺珏珠宝
濉溪界洪村优选店	界洪村优选店
曲阳县心系心意文化传媒有限公司	心系心意
岫岩满族自治县木落诚百货店	木落诚百货店
义乌市馨彩贸易有限公司	馨彩
潍坊高新区数五个数百货店	数五个数百货店
山东冠县海程交通设施有限公司	海程交通设施
五常市绿洲米业有限公司	绿洲米业
深圳市昊淼科技有限公司	昊淼
深圳小酌酒坊有限公司	小酌酒坊
白山市浑江区乐秀商贸行	区乐秀行
广州韩膜生物科技有限公司	韩膜
西安国际港务区屹川户外用品商行	港务区屹川商行
阳江市云晨商贸有限公司	云晨
安陆贵丰商贸有限公司	贵丰
湖南启新供应链管理有限公司	启新供应链
连城县尚之美服装店	尚之美服装店
黄岛区诺峨斌商贸店	诺峨斌店
东莞市云格信息科技有限公司	云格
平顶山市恒浩电子商务有限公司	恒浩
湖北新文道时代教育科技有限公司	新文道时代
田东县东桥农副产品经营部	东桥农副产品
湖南多途数字科技有限公司	多途数字
汇川区陈伦康食品经营部	陈伦康
即墨区静坐轩书店	区静坐轩书店
深圳效率科技有限公司	效率
上海钱坤圈电子商务有限公司	钱坤圈
成都如日中天商贸有限公司	如日中天
解放军医院_小店上线测试	解放军_上线测试
广州优柔美电子科技有限公司	优柔美
上海弥泉贸易有限公司	弥泉
东莞杰佳贸易有限公司	杰佳
义乌市颖尚电子商务商行	颖尚商行
四川六只小虎母婴用品有限公司	六只小虎母婴用品
深圳市缘梦拾贸易有限公司	缘梦拾
遵义市红花岗区金霖健身服务工作室	金霖健身工作室
郑州市雅泽商贸有限公司	雅泽
黄岛区苗通百货店	苗通百货店
威海凌晨妈妈教育科技有限公司	凌晨妈妈
南宁时合岁丰农业科技有限公司	时合岁丰
北京中视博美文化传媒有限公司	中视博美
临沂万强建筑工程机械有限公司	万强
信阳益源食品有限公司	益源
义乌市映山红电子商务有限公司	映山红
绍兴上虞富美伞业有限公司	富美伞业
郑州易泰迅达网络科技有限公司	易泰迅达
汝州市尚舒百货店	尚舒百货店
北京正亚生物科技有限责任公司	正亚
杭州萧山新街街道桐欢便利店	新街街道桐欢便利店
绍兴市上虞区亿诚日用品经营部	区亿诚日用品
乐至县鸿福水果专业合作社	鸿福水果专业合作社
杭州野犀科技有限公司	野犀
山西金铭恒威农业发展有限公司	金铭恒威
南康区律动摄像服务部	区律动摄像
重庆市荣懋生物科技有限责任公司	荣懋
汕头市潮阳区贵屿丹曼妮针织内衣厂	贵屿丹曼妮内衣厂
瑞丽市泽建珠宝店	泽建珠宝店
合肥信颖网络科技有限公司	信颖
伊春市禾源森林食品有限公司	禾源森林
山东蔚蓝航空科技有限公司	蔚蓝
深圳龙岗区皓悦服饰商行	皓悦商行
西安市碑林区博益商行	博益商行
响水县陈家港镇小懒喵创意生活馆	陈家港镇小懒喵
北京私享时代文化传播有限公司	私享时代
兰山区祺木粮方贸易商行	祺木粮方贸易商行
广州暖自商贸部	暖自
山东坤山贸易有限公司	坤山
霞浦县村花食品经营部	村花
北京解元教育咨询有限公司	解元
北京一览文化传媒有限公司	一览
武汉天成恒美贸易有限公司	天成恒美
通河县艺然绘画工作室	艺然绘画工作室
新郑市王寒日用百货店	王寒日用百货店
大厂回族自治县祁各庄镇宝艺大唐艺术行	祁各庄镇宝艺大唐行
嘉兴嘉佑信息科技有限公司	嘉佑
中研尚观科技（广州）有限公司	中研尚观
海安天天爆单百货店	天天爆单百货店
北京协和生物工程研究所有限公司	协和研究所
西藏曼卡龙网络科技有限公司	曼卡龙
中深产业控股(广东)有限公司	中深产业
深圳市万份之一科技有限公司	万份之一
十堰市沐森贸易有限公司	沐森
甘井子区南关岭街道艺蒂艾慕精品行	岭街道艺蒂艾慕精品行
河北思以源沫商贸有限公司	思以源沫
广州市传之作贸易有限公司	传之作
亳州市百洲堂生物科技有限公司	百洲堂
腾冲佳缘旅行社有限责任公司	佳缘旅行社
浙江集选科技有限公司	集选
南京特拉保科技有限公司	特拉保
安徽华亿米莱商贸有限公司	华亿米莱
杭州爱易果网络科技有限公司	爱易果
南昌圣川文化传媒有限公司	圣川
黄冈极速网络科技有限公司	极速
重庆洛施迦化妆品有限公司	洛施迦
淮北市相山区赵珩休闲食品店	赵珩休闲食品店
上海壹茗商贸有限公司	壹茗
成都龙腾威尔科技有限公司	龙腾威尔
固瑞克流体设备南通有限责任公司	固瑞克流体
五常市常星米业有限公司	常星米业
青岛爱私塾教育咨询有限公司	爱私塾
上海穿天杨网络科技有限公司	穿天杨
福州市鼓楼区菲之华服装经营部	菲之华
新乡市凤泉区好美味食品厂	好美味食品厂
心选（崇阳）商贸行	心选行
五家渠新湖农场静诺手机店	新湖农场静诺手机店
河南彩鲜绿色农业有限责任公司	彩鲜绿色
合肥黄麟商贸有限公司	黄麟
福州市巨神网络科技有限公司	巨神
湖北邓妍商贸有限公司	邓妍
五常市稻管家水稻种植专业合作社	稻管家水稻种植专业合作社
烟台经济技术开发区叶礼茶叶店	经济技术开发区叶礼茶叶店
深圳市香雅食品有限公司	香雅
杭州萧山城厢街道小雅鱼工艺品店	街道小雅鱼工艺品店
湖北小稀藤健康科技有限公司	小稀藤
开封市鼓楼区零点百货商行	零点百货商行
安徽铭茶堂生物科技有限公司	铭茶堂
北京美物计科技有限公司	美物计
浏阳市普迹镇欣依然服装店	普迹镇欣依然服装店
云南百收科技有限公司	百收
北京联科双诺商贸有限公司	联科双诺
汕头市博荟贸易有限公司	博荟
深圳市龙岗区冠金鑫商贸部	冠金鑫
济南金威刻科技发展有限公司	金威刻
赤壁市弘纱轩百货商行	弘纱轩百货商行
阜南县百味堂电子商务有限公司	百味堂
泉州鲜活美丽生物科技有限公司	鲜活美丽
天津速刷信息科技有限公司	速刷
泉州市泉港区名后日用品店	名后日用品店
安陆市梦依源服装店	梦依源服装店
郑州冲锋舟商贸有限公司	冲锋舟
福州市马尾区沃智百货商行	沃智百货商行
石家庄鼎赞网络科技有限公司	鼎赞
元氏县德贵综合门市	德贵综合门市
衡水国岳交通环境设施工程有限责任公司	国岳交通环境设施
瑞丽市帕瑞珠宝店	帕瑞珠宝店
义乌众想网络科技有限公司	众想
中山市诚象家具有限公司	诚象家具
莆田市秀屿区平海兴振百货店	平振百货店
库尔勒利真商行	利真商行
武汉沐婴生物科技有限公司	沐婴
太原市杏花岭区玉琴毛绒玩具加工部	玉琴毛绒玩具
蜂鸟字节（深圳）科技有限公司	蜂鸟字节
黄石嘉亚进出口贸易有限公司	嘉亚
山东岚兴劳务有限公司	岚兴
巴东县齐心授权专营店	齐心授权专营店
山东鸿帛商贸有限公司	鸿帛
莆田市盈高贸易有限公司	盈高
随州市菌旺农业科技有限公司	菌旺
山西九滴血电子商务有限公司	九滴血
上海来红商贸有限公司	来红
深圳市世联汇进出口有限公司	世联汇
宁波奥凯盛鼎信息科技有限公司	奥凯盛鼎
哈尔滨美惠自费留学中介有限公司	美惠自费留学中介
亳州市经典岁月酒业有限公司	经典岁月
高骞企业咨询服务（武汉）有限公司	高骞
龙港市瑞云服装商行	市瑞云商行
蓝桃文化（西安）股份有限公司	蓝桃股份
瑞丽市姐告伊柔珠宝柜	姐告伊柔珠宝柜
深圳全棉时代科技有限公司	全棉时代
河南易而购电子商务有限公司	易而购
绍兴市上虞区亿雅日用品经营部	区亿雅日用品
无锡硕艺钢结构工程有限公司	硕艺钢结构
天津欧德佳智能科技有限公司	欧德佳智能
佛山市禅城区悟空易购百货贸易行	悟空易购百货行
郑州三分学教育科技有限公司	三分学
杭州亚序科技有限公司	亚序
佛山在远方互联网科技有限公司	在远方
永康市飙神贸易有限公司	飙神
梧州蓝农人农贸有限公司	蓝农人农贸
山西人人淘电子商务有限公司	山西人人淘
丝路伴侣（广州）运营管理有限公司	丝路伴侣
遵化市教厂村琪琪商店	教厂村琪琪商店
杭州临安蕊蕊副食品商行	蕊蕊副食品商行
杭州原本网络科技有限公司	原本
杭州时光机文化传媒有限公司	时光机
北京天诺大陆科技有限公司	天诺大陆
信宜市钱排镇念夏鲜果店	钱排镇念夏鲜果店
杭州淘扑文化创意有限公司	淘扑
大连众智水产品有限公司	众智
彤妈美妆服饰（杭州）淘宝店	彤妈美妆淘宝店
滨海县东坎街道萌可日用品店	东坎街道萌可日用品店
灵川县李在艳农产品经营部	李在艳农产品
昆山川兴服装辅料有限责任公司	昆山川兴服装辅料
北京云聆商贸有限公司	云聆
河南省相辉信息技术有限公司	相辉
中科融媒（深圳）科技有限公司	中科融媒
临清市青鸟文化传媒有限公司	青鸟
松阳山中好物农业发展有限公司	山中好物
广州冰泉化妆品科技有限公司	冰泉
青岛明伟福泽商贸有限公司	明伟福泽
南宁市雕刻之家珠宝首饰店	雕刻之家珠宝首饰店
唐山谷津坊食品有限公司	唐山谷津坊
海口龙华心善诚零售网店	心善诚零售网店
佛山市禅城区爱宠族龟鳖店	爱宠族龟鳖店
东莞市凤岗甄选百货店	凤岗甄选百货店
北海日赚两百互联网科技有限公司	日赚两百
烟台莒草堂生物科技有限公司	莒草堂
义乌市三禹电子商务商行	三禹商行
东莞市慧越自动化设备科技有限公司	慧越
凉州区方言百货店	方言百货店
众智昌珠宝（佛山市）有限公司	众智昌珠宝
合肥耕博教育科技有限公司	耕博
天津亿鼎购贸易有限公司	亿鼎购
任丘盘古网络技术有限公司	盘古
深圳市龙岗区爱上商行	爱上商行
肃宁县圣添尼服装商行	圣添尼商行
苏州市尚礼巫电子商务有限公司	尚礼巫
武汉倾城电子商务有限公司	倾城
蚌埠市卓美商贸有限公司	卓美
山西二小子电子商务有限公司	二小子
广州御蔻坊生物科技有限公司	御蔻坊
莆田市南墨贸易有限公司	南墨
山东通锐信息科技有限公司	通锐
新罗区阿浩百货店	阿浩百货店
唐山市古冶区林西腾非电子商务服务部	腾非
翁源县觉照禅书店	觉照禅书店
潍坊市潍同健康咨询中心	潍同
东海县佳曦钰百货商行	佳曦钰百货商行
静笃（山东）文化科技有限公司	静笃
莆田市众易城贸易有限公司	众易城
武陟县大唛副食门市部	大唛副食门市部
市北区漫山金商行	漫山金商行
天津乐宝信息科技有限公司	乐宝
安徽泰越网络科技有限公司	泰越
连平县隆街镇黄小二农家干货店	隆街镇黄小二农家干货店
运城视讯文化传媒有限公司	视讯
黄山益徽坊电子商务有限公司	益徽坊
广州市月明贸易有限公司	月明
元氏县赵铁男工艺品店	赵铁男工艺品店
广州为美电子商务有限公司	为美
深圳可思美科技有限公司	可思美
湖南大美百川健康科技有限公司	大美百川
北京文博仕科技文化有限责任公司	文博仕
临清市美优美食品商贸库	美优美库
安徽康和同盛健康产业有限责任公司	康和同盛产业
古田蓝鲸谷网络科技有限公司	蓝鲸谷
北京道合天地网络科技有限公司	道合天地
义乌市裘福电子商务商行	裘福商行
唐山励弘科技有限公司	唐山励弘
杭州聚瑛汇网络科技有限公司	聚瑛汇
阳春智库（北京）科技有限公司	智库
广州市向日葵时代文化传媒有限公司	向日葵时代
瑞丽市新云贺珠宝有限公司	新云贺珠宝
山东橡果电子商务有限公司	橡果
上海聚蕉科技有限公司	聚蕉
广州永驰汽车用品有限公司	永驰
潍坊鲜满家供应链管理有限公司	鲜满家供应链
赣榆区海头镇倩倩海产品经营部	区海头镇倩倩海产品
瑞丽市翠也珠宝店	翠也珠宝店
宁夏杞里香枸杞有限责任公司	杞里香枸杞
深圳市优乐天信息咨询有限责任公司	优乐天
哈尔滨一粒粟电子商务有限公司	一粒粟
河南道物实业有限公司	道物
宿迁市亲滋味信息科技有限公司	亲滋味
名创优选科技（广州）有限公司	名创优选
大荔县恋惠优品	恋惠优品
宾县王木木服装店	王木木服装店
上海乐聚旅行社有限公司	乐聚旅行社
太和县阔源宠物销售有限公司	阔源
临沂瓦力机械设备有限公司	瓦力
莆田市荔城区思允服饰店	思允服饰店
宁夏神马行进出口贸易有限公司	神马行
武汉猴哥装饰设计有限公司	猴哥
萍乡经济技术开发区鹏军冰晶画工坊	经济技术开发区鹏军冰晶画工坊
庄浩林	庄浩林
文登区丿呗网络工作室	区丿呗工作室
安溪县凤城黄朝一品烟酒商行	黄朝一品烟酒商行
武汉星飞驰文化传播有限公司	星飞驰
亳州市锡安生物科技有限公司	锡安
赵军伟	赵军伟
文山市敏轻便利店	市敏轻便利店
常州七斤半网络科技有限公司	七斤半
四会市翠缘石玉器有限公司	翠缘石玉器
长春市二道区北域优品电子商务中心	北域优品
苍南鑫峰鞋业有限公司	鑫峰
天津新金马商贸有限公司	新金马
瑞丽市凤栖苑商贸有限公司	凤栖苑
东阿县东阿阿胶旅游养生有限公司	养生
桥东区畅邦日用品店	畅邦日用品店
水磨沟区昆仑路尚和美玉器店	昆仑路尚和美玉器店
苏州大马留学服务有限公司	大马留学
甘洛解古阿星农副产品经营部	解古阿星农副产品
温州市洞头东屏右见海岸民宿	东屏右见海岸民宿
广州馨泽文化传播有限公司	馨泽
当阳市龟谷水产养殖有限公司	龟谷水产养殖
丹阳市开发区觅依女装店	开发区觅依女装店
四川川哥再生资源开发有限公司	川哥再生资源
广州市白云区永平蓝心百货商行	蓝心百货商行
诸暨市童芯袜业有限公司	童芯袜业
鸿泰农林科技开发有限公司	鸿泰农林科技开发
重庆鼎盛天下科技有限公司	鼎盛天下
青岛松柏年电子商务有限公司	松柏年
五峰世琴特产店	五峰世琴特产店
哈尔滨超一代教育信息有限公司	超一代
四川极速电子商务有限公司	极速
杭州萧山琪忆心理健康咨询服务部	琪忆心理健康
北京诺信畅享科技有限公司	诺信畅享
莆田市城厢区慕尚百货商行	慕尚百货商行
迈福斯（天津）生物科技有限公司	迈福斯
金华市婺城区阿木电子商务商行	阿木商行
桐乡市乌镇儒曼服装店	乌镇儒曼服装店
安徽流金网络科技有限公司	流金
悦享全城（山西）科技有限公司	悦享全城
滕州市大坞泉盛综合商店	大坞泉盛综合商店
深圳市罗湖区悦已美百货商行	悦已美百货商行
宜兴市栖行电子商务中心	栖行
潍坊综合保税区御见名匠专业护肤中心	综合保税区御见名匠专业护肤
深圳市思胤然商贸有限公司	思胤然
北京荣宝斋科技有限公司	荣宝斋
北京锦绣东方图书有限公司	锦绣图书
深圳市艺流影享科技有限公司	艺流影享
天台露敏服装店	露敏服装店
济南金麦穗教育科技有限公司	金麦穗
成都德薇贸易有限公司	德薇
南靖县飞艳文化传播有限公司	飞艳
观途（上海）旅游服务中心（有限合伙）	观途有限
缙云县天勇贸易有限公司	天勇
临沂即刻广告传媒工作室	即刻工作室
四会市艳芬御翠坊翡翠专柜	艳芬御翠坊翡翠专柜
临沂逸品居商贸有限公司	逸品居
天台县霞萍汽车用品店	霞萍用品店
东莞市万峰印刷机械有限公司	万峰印刷
泉州市雯楷妍贸易有限公司	雯楷妍
沭阳县春夜喜雨电子商务中心	春夜喜雨
济源市轵城阿晋农产品经营部	轵城阿晋农产品
昆明成进祥管理服务有限公司	成进祥
威海好润文化传媒有限公司	好润
博兴县涵文图书经营馆	涵文图书经营
广州湘聚服饰有限公司	湘聚
衢州市衢江区奕杉家庭农场	奕杉家庭农场
北京百度网讯科技有限公司	百度网讯
龙游洛奇百货商行	洛奇百货商行
植养美张家口电子商务有限公司	植养美
宁城县莓食汇食品经销部	莓食汇经销部
六安泽烨商贸有限公司	泽烨
叶县天意种植专业合作社	天意种植专业合作社
佛山市红达钟表有限公司	红达钟表
瑞丽市椰特珠宝店	椰特珠宝店
深圳市思龙跃上电子商务有限公司	思龙跃上
涟水小狐姐姐宠物店	小狐姐姐宠物店
贵州汉羿酒业有限公司	汉羿
揭阳市良可尤商贸有限公司	良可尤
网红有道文化发展传媒（辽宁）有限公司	网红有道
常熟市莫城街道纳豆儿服装商行	莫城街道纳豆儿商行
荔波县小陶农副产品店	小陶农副产品店
富平县钰源轩百货店	钰源轩百货店
成华区腾誉网络科技工作室	腾誉工作室
河南大康锅炉有限公司	大康锅炉
深圳市扬子工业科技有限公司	扬子
陕西跃农门现代农业发展有限责任公司	跃农门现代农业
仙游县度尾镇朽木工坊工艺品店	度尾镇朽木工坊工艺品店
平阴县道地特产店	道地特产店
绍兴市上虞区新佳日用品经营部	区新佳日用品
吴中区东山西巷农产品经营部	东巷农产品
贵阳诺伙曼斯网络科技有限公司	诺伙曼斯
太仓市沙溪镇直塘舒漫雅家纺加工厂	沙溪镇直塘舒漫雅家纺加工厂
滕州市多想文化传媒有限公司	多想
兰山区佳银渔具经营部	佳银渔具
四会市一鸣惊人翡翠专柜	一鸣惊人翡翠专柜
西安炽一食品科技有限公司	炽一食品科技
厦门富裕通物流有限公司	通
广州枝叶服饰有限公司	枝叶
深圳伊凯路科技服务有限公司	伊凯路
雅安骐扬文化传媒有限公司	骐扬
南通八点半贸易有限公司	八点半
北京鑫润康谊生物科技开发有限责任公司	鑫润康谊
陕西物优聚美电子商务有限公司	物优聚美
山东憨憨乐农业有限公司	憨憨乐
章丘市华祥颗粒机械有限公司	章丘市华祥颗粒
天台葛敏优服装店	葛敏优服装店
淮安花溢苑园林绿化有限公司	花溢苑园林绿化
巴中市恩阳区小志土特产店	小志土特产店
大同市纽客滋电子商务有限公司	纽客滋
西安曲江新区微小店商贸行	新区微小店行
海南浪花餐饮管理有限公司	浪花
瑞丽市恒溪商贸有限责任公司	恒溪
宿豫区岚珀中控优化汽车用品店	宿豫区岚珀中控优化用品店
厦门网达科技有限公司	网达
长安可馨针纺织品商行	可馨针纺织品商行
青白江青橙服饰商贸经营部	青白江青橙
北京嘉禾卓越商贸有限公司	卓越
度城好物（山西省襄垣县）信息技术有限公司	度城好物
广州富维企业管理有限公司	富维
上海闺友网络科技发展有限公司	闺友
深圳市极兔网络科技有限公司	极兔
鼎唐（北京）文化艺术发展中心	鼎唐
上海陌野寻网络科技有限公司	陌野寻
长沙茶心佛语文化传播有限公司天心分公司	茶心佛语
金华市琳讯生物科技有限公司	琳讯
广州星愿景网络科技有限公司	星愿景
张国鑫	张国鑫
淄川区英佳达图书音像店	英佳达图书音像店
济宁信联信息技术服务有限公司	信联
山西火狐狸文化传媒有限公司	火狐狸
成都宏海洋物业管理有限公司	宏海洋
福州天池大兴贸易有限公司	天池
湖北尊禧福鹿健康产业发展有限公司	尊禧福鹿产业
青岛青丰侠科技网络有限公司	青丰侠
南郑区红庙镇雨荷土特产店	区红庙镇雨荷土特产店
武汉尚通影视文化传媒有限公司	尚通影视文化
安徽网新网络技术有限公司	网新
贵州黔粹誉酒业有限公司	黔粹誉
扬州道津万渡网络科技有限公司	道津万渡
安徽百青堂健康管理有限公司	百青堂
贵港市港北区鸿信德塑料制品厂	鸿信德厂
广州市瑞姬化妆品有限公司	瑞姬
江阴市周庄参差酒业商行	周庄参差商行
潮州市娅丝琳化妆品有限公司	娅丝琳
昆明耳东文化传媒有限公司	耳东
曲沃县网易源电子商务有限公司	网易源
佛山市禅城区仁福嘉电子商务经营商行	仁福嘉经营商行
深圳市宝安区鱼乐传媒中心	鱼乐
北京康源盛泰文化科技有限公司	康源盛泰
贵州省仁怀市赤奉酒业销售有限公司	赤奉
沈阳奥利美丝生物科技有限公司	奥利美丝
北京迪斯科为技术发展有限公司	迪斯科为
烟台淘古今网络技术有限公司	淘古今
靖边县圪梁梁文化传媒有限公司	圪梁梁
深圳市亦青藤电子科技有限公司	亦青藤
三河市墨羽珠宝设计有限公司	墨羽珠宝
贞丰县瑞丰苑家庭农场	瑞丰苑家庭农场
四会市兰慕珠宝店	兰慕珠宝店
沧州市运河区赖棒棒食品店	赖棒棒食品店
合肥智玮天盈科技有限公司	智玮天盈
百度在线网络技术（北京）有限公司	百度在线
山东怡恩供应链管理有限公司	怡恩供应链
佛山市禅城区百福具臻百货贸易行	百福具臻百货行
深圳市畅天游智能科技有限公司	畅天游智能
锦江区邻聚力日用品经营部	邻聚力日用品
赣榆区石桥镇悦丰食品经营部	区石桥镇悦丰
广西钦州诸葛云汽车服务有限责任公司	诸葛云
珠海绿橡树电子商务有限公司	绿橡树
北京醉纯大白科技有限公司	醉纯大白
广州市瑞美嘉贸易有限公司	瑞美嘉
达州市通川区增高乐贸易有限公司	增高乐
译研网络科技（上海）有限公司	译研
清华大学出版社有限公司	清华大学出版社
大连富生青春科技有限公司	富生青春
深圳市智兔网络科技有限公司	智兔
桐梓县维进土鸡养殖场	维进土鸡养殖场
莆田博斯亚电子商务有限公司	博斯亚
湖南猫窝文化传媒有限公司	猫窝
武功县悯农农业科技有限公司	县悯农
吴兴朵阳童装商行	朵阳童装商行
北京宠极科技有限公司	宠极
石狮市友盟贸易有限公司	友盟
洛阳市洛龙区天泽牡丹繁育基地	天泽繁育基地
上海华靓通讯科技有限公司	华靓
佛山市扶华堂健康咨询有限公司	扶华堂
赣榆区海头镇金惜海产品经营部	区海头镇金惜海产品
莆田市荔城区仁新服饰店	仁新服饰店
贵州当年情酒业股份有限公司	当年情股份
广安市广桑源农业发展有限公司	广桑源
渭源县有家土特产销售店	有家土特产销售店
泌阳县小王在乡村电子商务	小王在乡村
山西北方国际旅行社有限公司	北方旅行社
金华市小斑点文化传媒有限公司	小斑点
深圳市宝安区一元钱服装经营店	一元钱经营店
封丘县乐一文化传媒有限公司	乐一
杭州洛曼茵服饰有限公司	洛曼茵
连平县七月生态农业专业合作社	七月生态农业专业合作社
滑县道口滑业科技店	道口滑业店
兰山区固精堂保健食品经营店	固精堂保健食品经营店
辽宁两点半网络科技有限公司	两点半
上海翘维贸易有限公司	翘维
长沙市岳麓区怡之轩食品店	怡之轩食品店
利辛纳兰羽服装店	纳兰羽服装店
杭州朱府文化发展有限公司	朱府
贵州千宝科技有限公司	千宝
榆社恩源信息科技有限公司	恩源
江北新区巴巴克商贸中心	新区巴巴克
平潭丝蕴批发经营部	丝蕴
天台鑫速电子商务有限公司	鑫速
郑州市法易德商贸有限公司	法易德
广州淑抱盛贸易有限公司	淑抱盛
南阳寻木网络科技有限公司	寻木
深圳市赋宇电子商务有限公司	赋宇
莆田市玉琳轩贸易有限公司	玉琳轩
武冈市博济健康堂	博济堂
诸暨市领英针织厂	领英针织厂
苏州帕加迪车业科技有限公司	帕加迪车业
阜新千客万来商贸有限公司	千客万来
北京智泽华软件有限责任公司	智泽华
贵州黔袍酒业有限公司	黔袍
深圳利孚生物科技有限公司	利孚
东坡区衣美人服装店	衣美人服装店
邵东县廉桥镇心雨滋补食品经营部	廉桥镇心雨滋补食品
莘县瓜小农鲜果有限公司	瓜小农鲜果
泉州市道颂商贸有限公司	道颂
重庆七程信息科技有限公司	七程
深圳市伽雷可斯科技有限公司	伽雷可斯
洛阳市伊滨区小胖墩商贸行	伊滨区小胖墩行
山东高速满易物流科技有限公司	高速满易
特鲁门（北京）科技有限公司	特鲁门
成华区马瑞丰商贸部	马瑞丰
滨城区倾芭媛服装店	倾芭媛服装店
山东百兴福农业发展股份有限公司	百兴福股份
铜仁贵聚程科技有限公司	贵聚程
杭州炳耀网络科技有限公司	炳耀
高阳县宁皓商贸有限公司	宁皓
夏邑县游啊洲百货门市部	游啊洲百货门市部
北海寻海珠宝有限公司	寻海珠宝
广州太吉新材料有限公司	太吉新
深圳市福晋五金制品有限公司	福晋五金制品
嘉祥县城区国丰电脑店	国丰电脑店
兰山区华义图书店	华义图书店
山西路小路小米生态农业有限公司	山西路小路小米生态农业
山西华北强农业种植专业合作社	华北强种植专业合作社
温州市龙湾永中鸿迪日用品店	永中鸿迪日用品店
宜城市果子美酒坊	果子美酒坊
河北寰星电子商务有限公司	寰星
西安市莲湖区福聚拢商行	福聚拢商行
国兴绿保（北京）科技有限公司	国兴绿保
缙云县玖狮塔婴童用品有限公司	玖狮塔婴童用品
合肥酷尔星商贸有限公司	酷尔星
山东庄周鞋业有限公司	庄周
深圳市宝安区西乡依依不奢商行	依依不奢商行
再生美（上海）医疗美容诊所有限公司	再生美诊所
屏南县旭阳电器商行	旭阳商行
南宁良庆区广诚教育咨询工作室	广诚工作室
深圳德沃时尚电子商务有限公司	德沃时尚
杭州老蔡翡翠淘宝珠宝店	老蔡翡翠淘宝珠宝店
上海花豆实业有限公司	花豆
四会市正东玉器商行	正东玉器商行
山东聚川成网络科技有限公司	聚川成
通化聚鑫经济开发区喜洋参坊	聚鑫经济开发区喜洋参坊
北京科锐昂科技发展有限公司	科锐昂
洛阳欧维盾门窗科技有限公司	欧维盾门窗
汝阳县古城机械厂	机械厂
金湖天山南北食品有限公司	金湖天山南北
纳通生物科技（北京）有限公司	纳通
美物甄选（武汉）信息技术有限公司	美物甄选
山东兵兵电子商务有限公司	兵兵
南京顺华网络科技有限公司	顺华
北京中公教育科技有限公司	中公
三门篮阅贸易商行	篮阅贸易商行
上海储茂国际贸易有限公司	储茂
兴县马小君电子商务有限公司	马小君
上海正绍文化发展有限公司	正绍
南平市建阳区林农蒂芙尼百货店	区林农蒂芙尼百货店
泉州市果壳网络科技有限公司	果壳
东莞市龙欣硅胶制品有限公司	龙欣硅胶
河南银晨锅炉集团有限公司	银晨锅炉
上海财孵宝网络科技有限公司	财孵宝
四会市家茂翡翠店	家茂翡翠店
陕西益善康医疗器械有限公司	益善康
兰考县壹叁信息服务有限公司	壹叁
新疆趣店科技有限公司	趣店
海港区润格贸易部	润格贸易部
重庆秒闻电子商务有限公司	秒闻
深圳市吉瑞鑫科技有限公司	吉瑞鑫
深圳市龙岗区顶峰财税咨询部	顶峰财税咨询部
兰山区三联百货食品商行	三联百货商行
西安市莲湖区顺顺尼商贸店	顺顺尼店
贵州醉聚源酒业有限公司	醉聚源
新昌县澄潭镇茶老爹茶叶店	澄潭镇茶老爹茶叶店
甘肃经纬信息科技有限公司	经纬
山东华凯诺尔科技有限公司	华凯诺尔
前郭县平凤乡华粮种植养殖农民专业合作社	前郭县平凤乡华粮种植养殖农民专业合作社
苏州福礼严选企业管理有限公司	福礼严选
深圳瑞光步科技有限公司	瑞光步
南京斐星益电子科技有限公司	斐星益
广州卡卡服饰有限公司	卡卡
南平市建阳区琳松涉百货商行	区琳松涉百货商行
滨州市云信网络科技有限公司	云信
郑州万宝游乐设备有限公司	万宝游乐
河北玉湖贸易有限公司	玉湖
阜阳融大企业管理咨询有限公司	融大
仙桃市聪宝农产品店	聪宝农产品店
吉林省森然商贸有限公司	森然
北京联沃农业科技有限公司	联沃
大丰米粒儿科技有限公司	米粒儿
深圳市马邑电子商务有限公司	马邑
安陆市皮皮精品童装店	皮皮精品童装店
南通慕居纺织科技有限公司	慕居
仙游县鲤城暖风服装店	暖风服装店
深圳十洲传媒科技有限公司	十洲
山东瑞朗网络科技有限公司	瑞朗
晋江荣协贸易有限公司	荣协
漳州幸福园农产品有限公司	幸福园农产品
鹰潭市信江新区玛夏书店	信江新区玛夏书店
海口美兰百宝箱日用品店	百宝箱日用品店
文昌会文星月坊工艺品店	会文星月坊工艺品店
四会市东城区传家宝玉器行	传家宝玉器行
张家界新诚国际旅行社有限公司	新诚旅行社
山西晋膳晋食科技有限公司	山西晋膳晋食
江苏美沥特道路面材料有限公司	美沥特道路面
山东边下电子商务有限公司	边下
河北启丞传合企业管理咨询有限公司	启丞传合
珠山区彭氏陶瓷工作室	彭氏工作室
无极县玉盛酒经销部	玉盛酒经销部
市北区竹之晶家居用品商行	竹之晶商行
秦皇岛泷泽门窗科技有限公司	泷泽门窗
广州市柏淘皮具有限公司	柏淘皮具
宁晋县九之州信息技术服务中心	九之州
华容县好味道食品有限公司	好味道
陕西美农网络科技有限公司	美农
深圳市顺利玖贸易有限公司	顺利玖
杭州大希地科技股份有限公司	大希地
杭州奥科环境试验设备有限公司	奥科环境试验设备
吉林省春雨秋风科技有限公司	春雨秋风
沈阳玖壹科技实业有限公司	玖壹科技实业
保泰商务科技（大连）有限公司	保泰商务
如皋市博博食品店	博博食品店
无锡阿妈家政服务有限公司	阿妈
庄河市远东农业发展有限公司	远东
安徽古井云商电子商务有限公司	古井云商
尉氏县亚希服装店	亚希服装店
赣州市均衡医疗器械有限公司	均衡
宜兴易发信息技术有限公司	易发
北京中海建国酒业有限公司	中海建国
北镇市三宝农牧有限公司	市三宝农牧
义乌市域贞电子商务商行	域贞商行
麻雀直播文化传媒（深圳）有限公司	麻雀直播
宁波番薯格网络科技有限公司	番薯格
三明浩博网络传媒有限公司	浩博网络传媒
永安市燕南街诺新网络工作室	燕南街诺新工作室
上海青澄纺织科技有限公司	青澄
广州市易凯文化传媒有限公司	易凯
六安市瑞通网络科技有限公司	瑞通
上海兮鸿智能门窗有限公司	兮鸿智能门窗
天台荣杉快餐店	荣杉快餐店
深圳市慈心梅生物科技有限公司	慈心梅
揭阳产业园霖磐镇倚天电子商务经营部	产业园霖磐镇倚天
安徽伊升伊势商贸有限公司	伊升伊势
浙江蚁帮文化传媒有限公司	蚁帮
湖北新农康农业发展有限公司	新农康
瑞丽市靖蒂珠宝店	靖蒂珠宝店
义乌市苏希电子商务商行	苏希商行
东莞市东城沈公子电子商务店	沈公子店
抚州无线互联科技有限公司	无线互联
福建一诗二画信息科技有限公司	一诗二画
杭州佑禾生物科技有限公司	佑禾
广州市荔湾区云茶居茶行	云茶居茶行
山东浩森花木有限公司	浩森花木
广州云蜂贸易有限公司	云蜂
深圳市福田区京兆尹电子商务工作室	京兆尹工作室
黄岛区东昵百货店	东昵百货店
赣州美友哒家具有限公司	美友哒家具
石家庄爱滢禾信息科技有限公司	爱滢禾
惠州市惠阳区沙田好享家便利店	好享家便利店
伊美区龙跃食品店	伊美区龙跃食品店
霍邱县佰盛科技有限公司	佰盛
石家庄市一轩保洁服务有限公司	一轩
山东嘉锐文化传媒有限公司	嘉锐
兜麦电子商务（深圳）有限公司	兜麦
天台雅度汽车用品经营部	雅度
铜川市王益区江小芳农产品经销店	江小芳农产品经销店
潍坊熙悦贸易有限公司	熙悦
深圳市龙岗区百家旺百货商行	百家旺百货商行
昌宁县润丰农业科技有限公司	润丰
临沂邸报文化传媒有限公司	邸报
宁波易升品车汇汽车服务有限公司	易升品车汇
李沧区绿悠然家居用品店	绿悠然店
南京你禾我农业有限公司	你禾我
福建省安溪大韵茶业有限公司	大韵茶业
山西逆境生物科技有限公司	逆境
象山游渔生鲜经营部	游渔生鲜
七台河市桃山区鑫鑫科技电脑工作室	鑫鑫电脑工作室
盖州市太阳升办事处回东阁日用百货商店	太阳升办事处回东阁日用百货商店
灵川县益惠种养专业合作社	益惠种养专业合作社
巩义市华盛铭重工机械厂	华盛铭重工机械厂
深圳市秋媛电子商务有限公司	秋媛
山西天之润枣业有限公司	天之润枣业
周口市东新区舍我工作室	东新区舍我工作室
东海县典果百货店	典果百货店
义乌市心澄家居用品有限公司	心澄
西安伊凡美学形象设计管理有限公司	伊凡美学形象设计
南阳城乡一体化示范区甄选蔬菜水果坊	城乡一体化示范区甄选蔬菜水果坊
长沙宠伴宠物用品有限公司	宠伴宠物用品
东海县鼎达珠宝有限公司	鼎达珠宝
江楠（沧州）文化发展有限公司	江楠
合肥经济技术开发区谜兔先生桌游设计工作室	经济技术开发区谜兔先生桌游工作室
深圳云麦科技有限公司	云麦
保定智旺门窗销售有限公司	智旺门窗
夜有星文化传媒辛集有限公司	夜有星
珲春京伟水产品批发店	京伟批发店
义乌市万店贸易有限公司	万店
佛山市泰嘉安防科技有限公司	泰嘉安防
三河市赫拉克勒商行	赫拉克勒商行
广州婉丽贸易有限公司	婉丽
深圳嘉智乐进出口有限公司	嘉智乐
河南欣余佳智能科技有限公司	欣余佳智能
佛山市店群科技有限公司	店群
嘉祥县佑亿特种动物家庭农场	佑亿特种动物家庭农场
宝鸡元香氏餐饮有限公司	元香氏
东莞资养堂医药有限公司	资养堂医药
南京市江宁区路畅交通设施销售中心	路畅交通设施
义乌市春学电子商务商行	春学商行
通州区川姜镇御寝阁纺织品厂	川姜镇御寝阁纺织品厂
瑞丽市金文云珠宝店	金文云珠宝店
江苏海美瑞温室科技有限公司	海美瑞温室
安徽常青藤电子商务有限公司	常青藤
河间醉梦渔具店	醉梦渔具店
保定白沟新城宗柏文具店	白沟宗柏文具店
陵水提蒙施兰芳水果经营部	陵水提蒙施兰芳水果
五指山万家宝科技有限公司	万家宝
界首市宏致电子商务有限公司	宏致
北京一图图书有限公司	一图图书
云南旭博网络信息科技有限公司	旭博
淮北市芳卿茂贸易有限公司	芳卿茂
杭州市西湖区美泠人文化工作室	美泠人工作室
易店联（上海）商贸有限公司	易店联
汉川市你好王小二服装经营部	你好王小二
北京云教互动科技有限公司	云教互动
梁山启航广告设计服务经营部	启航
腾冲市腾越镇李氏香道馆	市腾越镇李氏香道馆
深圳市龙岗区黎安妮服装厂	黎安妮服装厂
河北欧潮建筑工程有限公司	欧潮
高州市木希农产品店	木希农产品店
连平县三道生态农业发展有限公司	三道生态农业
原阳县蕾蕾化妆品网店	蕾蕾网店
韩城市龙门镇杨华服装店	龙门镇杨华服装店
广州伐大柴信息科技有限公司	伐大柴
湖南聪源教育科技有限公司	聪源
宁夏红网络科技有限公司	宁夏红
临沂峻峻网络科技有限公司	峻峻
濮阳县奥贝邦卫生用品有限责任公司	奥贝邦卫生用品
五华县华城镇满堂电子商务中心	华城镇满堂
福清叁玺网络科技有限公司	叁玺
孝南区美妙百货店	美妙百货店
北京田缘农业科技发展有限公司	田缘
章丘区帅三百货店	区帅三百货店
山西天粮网络科技有限公司	天粮
广州柔娜儿化妆品有限公司	柔娜儿
林州市浩淼商贸有限公司	浩淼
山东柏川经贸有限公司	柏川经贸
福建有点内容文化传媒有限公司	有点内容
上海玖匠电子商务有限公司	玖匠
北京华洋亿家贸易有限公司	华洋亿家
安徽优美达电子商务有限公司	优美达
雨辰隆康（北京）贸易有限公司	雨辰隆康
瑞丽市瑶刚珠宝店	瑶刚珠宝店
徐州福达润玻璃制品有限公司	福达润玻璃制品
邵阳县塘渡口镇咖喱食品店	塘渡口镇咖喱食品店
惠州市惠阳区淡水利有百货店	淡水利有百货店
浙江车检检汽车服务有限公司	车检检
帝鸿商务咨询（上海）有限公司	帝鸿商务
封开县长安镇哇卷百货商店	长安镇哇卷百货商店
广西博白县熹微文化传媒有限公司	熹微
沭阳帝茂绿化园林有限公司	帝茂绿化园林
广东精恒塑胶电子有限公司	精恒塑胶
桐乡市梧桐冬羽服装店	梧桐冬羽服装店
绿梦科技有限公司	绿梦
湖北依康源商务有限公司	依康源商务
深圳市云赫锦晨科技有限公司	云赫锦晨
云南中普良生物科技有限公司	中普良
海口美兰中蜜扫百货店	中蜜扫百货店
广州浅草网络科技有限公司	浅草
西安市高新区兆易信息工作室	兆易工作室
南通常友家居用品有限公司	南通常友
西山区翠御轩珠宝店	翠御轩珠宝店
广西昭平县七冲瑶山生态农业有限公司	七冲瑶山生态农业
涿州市宇芳共行综合商店	宇芳共行综合商店
义乌市珩杰电子商务商行	珩杰商行
常州市绿草茵种业科技有限公司	绿草茵种业
珲春市大漂亮食品网店	大漂亮网店
上海小度技术有限公司	小度
北京国瑞堂生物医药有限公司	国瑞堂生物医药
新泰市小协镇郭洪群百货商店	小协镇郭洪群百货商店
喜得上（北京）健康科技有限公司	喜得上
湖北满芳庭文化传媒有限公司	满芳庭
广州华南协和大健康信息有限公司	华南协和大
重庆紫福来科技有限公司	紫福来
上海墨希信息科技有限公司	墨希
陕西悦弘翔速网络科技有限公司	悦弘翔速
深圳市龙岗区京品智能商行	京品智能商行
上饶市清峰农业发展有限公司	清峰
成都市恒华装饰工程有限公司	恒华
平定县半渡电子商务部	半渡
江苏裕华杜鹃种植有限公司	杜鹃种植
弥渡同萌经营部	同萌
南昌市白云机动车驾驶员培训中心有限公司	机动车驾驶员培训中心
安陆市瑞尔商贸有限公司	瑞尔
兰山区君合星商贸店	君合星店
锦江区淘点点日用百货经营部	淘点点日用百货
山西密家茶叶有限公司	密家茶叶
北京京图伟业文化艺术发展有限公司	京图伟业
广饶义乌小商品批发市场永辉钟表店	小商品批发市场永辉钟表店
北京万哲商贸有限公司	万哲
上海义辰信息科技有限公司	义辰
东莞市东城易美易贸易商行	易美易贸易商行
福建泉州市铁马茶业有限公司	铁马茶业
瑞丽市明瑶珠宝店	明瑶珠宝店
华茜网络科技（上海）有限公司	华茜
南昌谷风堂网络科技有限公司	谷风堂
湖北省尊禧鹿业有限公司武汉分公司	尊禧鹿业
南康区简居时代电子商务店	区简居时代店
东海县洪庄镇乔文超百货商行	洪庄镇乔文超百货商行
福州奇思妙想文化传播有限公司	奇思妙想
长沙市天心区安强网络技术服务部	安强
西安市未央区凡偶经电子产品经营部	凡偶经电子产品
广州市花都区花城苏以化妆品商行	花城苏以商行
方彩（广州）贸易有限公司	方彩
杭州严选良品网络科技有限公司	严选良品
鄂州市鹏财贸易有限公司	鹏财
双塔区七味图书零售店	七味图书零售店
河南云雾科技有限公司	云雾
武汉市江岸区明镇蔬菜经营部	明镇蔬菜
福州市仓山区进源日用品商行	进源日用品商行
深圳市看门神电子有限公司	看门神
安乡县任平打印社	任平打印社
江海区米儿姐姐商行	米儿姐姐商行
河南轩而德商贸有限公司	轩而德
济南市天桥区莹致百货商行	莹致百货商行
北京华夏凯睿科技有限公司	华夏凯睿
余姚市之秋女装店	之秋女装店
河东区金科文体用品店	金科文体用品店
石家庄候起网络科技有限公司	候起
深圳市天亨实业有限公司	天亨
珙县巡场谭雪美妆网店	巡场谭雪美妆网店
卢龙县乾木电子商务有限公司	乾木
贵州茅硕酒业集团有限公司	茅硕
西安龙胜教育科技有限公司	龙胜
西安积木家信息科技有限公司	积木家
天台谌然电子商务商行	谌然商行
临沂延奎电子商务有限公司	延奎
深圳市好好能源科技有限公司	好好
宁波浙源信息技术有限公司	浙源
陇南雷迅电子商务有限公司	雷迅
云南微联科技有限公司	微联
河南向天歌装饰工程有限公司	向天歌
西安抱米花电器有限公司	抱米花
清远市清新区龙颈镇小龙马网络科技经营部	区龙颈镇小龙马
湖北野草文化传媒有限公司	野草
北京天马联盟科技有限公司	天马联盟
河北康安药业有限公司	康安
广州昌狼贸易有限公司	昌狼
瑞丽市臻帅珠宝有限公司	臻帅珠宝
抚州临川区科沃农业种植专业合作社	科沃种植专业合作社
长沙市芙蓉区彩彩优品百货商行	彩彩优品百货商行
济南凯乐乐器有限公司	凯乐
深圳市德盛将来科技有限公司	德盛将来
厦门市指丰科技有限公司	指丰
宜兴市众器文化发展有限公司	众器
三门峡市辉晟互联网零售有限责任公司	辉晟零售
深圳市南山区天涯果果贸易商行	果果贸易商行
平顶山市峰君商贸有限公司	峰君
屏南县逸居贸易商行	逸居贸易商行
兰山区晨普贸易商行	晨普贸易商行
武汉市江夏区柒朴服装店	柒朴服装店
杭州鲸浪网络科技有限公司	鲸浪
瑞丽市汇能农副产品店	汇能农副产品店
佛山市禅城区金名秋日用品贸易部	金名秋日用品贸易部
鄄城县百变工艺品店	百变工艺品店
北京京华阁书画院	京华阁书画院
合肥味滋源商贸有限公司	味滋源
中国联合网络通信有限公司深圳市分公司	网络通信
新华区有趣印记信息技术中心	有趣印记
腾冲市熊小二土特产店	市熊小二土特产店
厦门大白科技有限公司	大白
深圳市泉佳宝饮水设备有限公司	泉佳宝饮水
鄂州市金克五金经营部	金克
潍坊瑞泽苑生态农业有限公司	瑞泽苑生态农业
虞城县阎溪百货部	阎溪百货
西安市碑林区启帆商行	启帆商行
吐鲁番市易拍客电子商务有限公司	易拍客
嘉兴以晟网络科技有限公司	以晟
奇泉（天津）网络科技有限公司	奇泉
安徽文鸾网络科技有限公司	文鸾
福建秀永妍科技有限公司	秀永妍
永定区芊楠傲百货店	芊楠傲百货店
南阳市云网互联广告有限公司	云网互联
东莞时全贸易有限公司	时全
清丰县小董美食专卖店	小董美食专卖店
运城市玲玲商贸有限公司	玲玲
中山市天哲商贸有限公司	天哲
广州诺亚电子商务有限公司	诺亚
合肥淘抖抖网络科技有限公司	淘抖抖
杭州蝶霈电子商务有限公司	蝶霈
农垦黑蜂（北京）科技有限公司	农垦黑蜂
恋尚优品(宜昌)电子商务有限责任公司	恋尚优品
广州足下风情针织品贸易有限公司	足下风情针织品
福州大尊贸易有限公司	大尊
义乌市沐锦网络科技有限公司	沐锦
焦作市鑫恒艺商贸有限公司	鑫恒艺
东莞元润堂生物科技有限公司	元润堂
长沙秦童信息有限公司	秦童
山东白果网络科技有限公司	白果
湖南九农王机电设备有限公司	九农王
陆河县城敏创服装店	城敏创服装店
淄博阿乐泰旅行用品有限公司	阿乐泰用品
湖北时代万新国际教育发展有限公司	时代万新
济南瑞成环美家电清洗服务有限公司	瑞成环美家电清洗
广州星悦品牌管理有限公司	星悦品牌
安陆市思杰商行	思杰商行
广州独角兽电子商务有限公司	独角兽
宜沃尼（北京）商贸有限公司	宜沃尼
杭州我们的家电子商务有限公司	我们的家
温岭市大溪超亦电子商务网店	大溪超亦网店
赣榆区石桥镇丽强海产品经营部	区石桥镇丽强海产品
诸暨市乔尔针织厂	乔尔针织厂
苏州衣佳祥服饰有限公司	衣佳祥
临沂宣信文化传媒有限公司	宣信
山东哈维药业有限公司	哈维
黄岛区乐东迷百货店	乐东迷百货店
项城市付集忆梦书店	项城市付集忆梦书店
信阳市羊山新区久宁茶叶经营店	羊山新区久宁茶叶经营店
吉林省阿凡提科技有限公司	阿凡提
深圳市奥之博科技有限公司	奥之博
佛山市奈思电子商务有限公司	奈思
北京沃野沐秦科技有限公司	沃野沐秦
西安维一佳商贸有限公司	维一佳
嘉兴智高金属制品有限公司	智高金属制品
山西晋味美电子商务有限公司	山西晋味美
四会市玺悦珠宝店	玺悦珠宝店
成都和鑫润泽商贸有限公司	和鑫润泽
上海君图信息科技有限公司	君图
菏泽市牡丹区花姑娘牡丹种植有限公司	花姑娘种植
瑞丽市姐告空灵珠宝行	姐告空灵珠宝行
东莞市长安炫站服装店	炫站服装店
惠州市惠城区萱语百货商行	萱语百货商行
深圳市佳家旺商贸有限公司	佳家旺
为果教育科技（天津）有限公司	为果
瑞昌市健发贸易有限公司	健发
大宁红绿色农牧业专业合作社联合社	红绿色农牧业专业合作社联合社
浙江云车品电子商务有限公司	云车品
北京悦昕动文化传媒有限公司	悦昕动
四会市石头荟珠宝店	石头荟珠宝店
山东邦克日用品有限公司	邦克日用品
星精选（北京）网络科技有限公司	星精选
中山市卓东纺织服饰有限公司	卓东
濮阳市便宜淘电子商务有限公司	便宜淘
广州市沃克隆贸易有限公司	沃克隆
洛阳市西工区家和万兴百货店	家和万兴百货店
广西幸福联社供应链管理有限公司	幸福联社供应链
安陆市百变阁服装店	百变阁服装店
北京塞宾科技有限公司	塞宾
陕西柯维互动信息技术有限公司	柯维互动
福建省阿米特种装备有限公司	阿米特种
广州市丽优哲信息技术有限公司	丽优哲
菏泽市牡丹区汉泽花卉苗木经营部	汉泽花卉苗木
厦门老山香道股份有限公司	老山香道股份
厦门海底粮仓电子商务有限公司	海底粮仓
方雪	方雪
湖南央际教育科技有限责任公司	央际
深圳市贵思贸易有限公司	贵思
上海拓纷机械设备有限公司	拓纷
高州市分界镇黄菇凉农产品店	分界镇黄菇凉农产品店
睢宁县鑫克雷百货店	鑫克雷百货店
翼城星之耀网络传媒有限责任公司	星之耀网络传媒
上海天琥教育培训有限公司	天琥培训
长沙深得网络科技有限公司	深得
凉州区小火花电子商务经营部	小火花
沧州艾诺威电子设计有限公司	艾诺威电子设计
青岛仙人掌文化传媒有限公司	仙人掌
威海智鸟旅行社有限公司	智鸟旅行社
山西集智广益科技有限公司	集智广益
浙江可狄网络科技有限公司	可狄
江苏丰冠科技有限公司	丰冠
苍南县龙港罗典鞋厂	罗典鞋厂
新罗区恒祥家电维修部	恒祥家电维修部
贵州民族酒业(集团)销售有限公司	民族
临朐起色云顶服饰商贸中心	起色云顶
青岛宜阳陆顺轮胎有限责任公司	陆顺轮胎
赣榆区青口镇春之秋海产品经营部	区青口镇春之秋海产品
宁波含鑫自动化科技有限公司	含鑫
湖南果惠农业科技有限公司	果惠
苏州大平衡食品有限公司	大平衡
沈阳市沈河区德星文化用品店	德星用品店
学得在线（武汉）教育科技有限公司	学得在线
曲周县坤奇鱼缸门市	坤奇鱼缸门市
湖北神丹健康食品有限公司	神丹
沧州爱纳康防护设备有限公司	爱纳康防护
郑州乐铁供应链管理有限公司	乐铁供应链
安陆市丽萨商行部	丽萨商行
株洲爱货贸易有限公司	爱货
台州恩萱贸易有限公司	恩萱
哈尔滨市通香贡商贸有限公司	通香贡
合肥德炬电子商务有限公司	德炬
湖北头号松鼠果科技有限公司	头号松鼠果
机械工业出版社	出版社
山西雯雅电子科技有限公司	雯雅
吉林省五色豆电子商务有限公司	五色豆
长沙梦双文化传播有限公司	梦双
四会市翠丰缘珠宝行	翠丰缘珠宝行
宜兴市宝涵紫砂文化有限公司	宝涵紫砂
安徽与君酒业有限公司	与君
贵州酒重天贸易有限公司	酒重天
滦平鹏琴商贸有限公司	鹏琴
贵州中明酒业有限责任公司	中明
北京盛和顺餐饮管理有限公司	盛
成都梅寒香商贸有限公司	梅寒香
苏州芦苇科技有限公司	芦苇
定州市壮果家纺店	壮果家纺店
迈哈特（北京）文化传播有限公司	迈哈特
广州脉宝贝纪念品有限公司	脉宝贝纪念品
义乌市芒颖电子商务商行	芒颖商行
四会市小安珠宝店	小安珠宝店
深圳市深德克科技有限公司	深德克
西安习小乐教育科技有限公司	习小乐
临沂薇蕨商贸有限公司	薇蕨
吉香堂（海南）贸易有限公司	吉香堂
南阳非凡网络科技有限责任公司	非凡
苏州酷曼软件技术有限公司	酷曼
广州晟杰林贸易有限公司	晟杰林
甘肃绿盟牡丹产业科技发展有限公司	绿盟产业
萍乡聚辰禾贸易有限公司	聚辰禾
喜奔大健康科技（东莞）有限公司	喜奔大
泉州星境鞋业有限公司	星境
深圳市福田区百利捷数码科技商行	百利捷数码科技商行
清河县北卡汽车配件门市部	北卡门市部
广州博耀美容科技有限公司	博耀
洛川优然四季农业专业合作社	优然四季专业合作社
建宁县新兴电子商务有限公司	
福州市仓山区伟恒食品商行	伟恒商行
明师友信（北京）科技有限公司	明师友信
章鱼宝宝（济南）科技发展有限公司	章鱼宝宝
山西平头哥电子商务有限公司	平头哥
亳州市金多多生物科技有限公司	金多多
义乌卓曦贸易有限公司	卓曦
亮风台(上海)信息科技有限公司	亮风台
杭州鼎汉时装有限公司	鼎汉时装
深圳市爱贝鑫科技有限公司	爱贝鑫
广东新概念汽车服务集团有限公司	新概念
兰山区小昂百货商店	小昂百货商店
历城区鲜荣园艺花卉店	鲜荣园艺花卉店
西咸新区空港新城珍亮红美百货店	西咸新区空港珍亮红美百货店
四川中和农道农业科技有限公司	中和农道
甘肃银正信息技术有限公司	银正
陕西奇草园生物科技有限公司	奇草园
宜兴市丁蜀镇庞红昌陶瓷经营部	丁蜀镇庞红昌
四会市小九妹珠宝店	小九妹珠宝店
广州尊瑞贸易有限公司	尊瑞
义乌市勇捷电子商务有限公司	勇捷
杭州创年网络科技有限公司	创年
上海乐麦网络科技有限公司	乐麦
石狮果奇岚帛服饰贸易有限公司	果奇岚帛
郑州天途生物科技有限公司	天途
贵州酱香汇酒业有限公司	酱香汇
深圳市兆瑞网络科技有限公司	兆瑞
日照经济技术开发区胖妮美食海鲜食品有限公司	经济技术开发区胖妮美食海鲜
遂溪县遂城福康食品工作坊	遂城福康工作坊
北京全聚德仿膳食品有限责任公司	全聚德仿膳
镇江高新区星花漾百货店	星花漾百货店
仙游县鲤南王清水珠宝商行	鲤南王珠宝商行
博兴县博昌办事处恒锦图书店	博昌办事处恒锦图书店
陕西极速恐艾信息科技部	极速恐艾科技部
内蒙古齐歌文化传媒有限公司	齐歌
天津市青木文化传媒有限公司	青木
海口美兰蓝纳商贸中心	蓝纳
成都艾帮信息科技有限公司	艾帮
多伦县其木格食品店	其木格食品店
乌鲁木齐娜塔莎商贸有限公司	娜塔莎
深圳友软科技有限公司	友软
安徽虹丹智能家居有限公司	虹丹智能家居
深圳市华一世纪企业管理顾问有限公司	华一世纪
陕西煜之熠生物科技有限公司	煜之熠
深圳朵维科技有限公司	朵维
安徽中绅之宝电子商务有限公司	中绅之宝
东莞市智彤包装制品有限公司	智彤包装
广州岚萃贸易有限公司	岚萃
南平市建阳区云水禅心建盏文化有限公司	区云水禅心建盏
泗水博信电子科技有限公司	博信
北京吉祥一甲电子商务有限公司	吉祥一甲
上海优萃生物科技有限公司	优萃
深圳市祺御智能科技有限公司	祺御智能
惠州市敏捷电子商务有限公司	敏捷
太原市杏花岭区宝葫芦工艺礼品商行	宝葫芦工艺礼品商行
河南俏巴网络科技有限公司	俏巴
开封市海知龙电子商务有限公司	海知龙
青岛小松鼠服饰有限公司	小松鼠
四川故食集商贸有限公司	故食集
自贡美加电子商务有限公司	美加
佛山市南海区珍味飘食品贸易商行	珍味飘贸易商行
苍南县凡辰电子商务商行	凡辰商行
上饶市忠和堂供应链管理有限公司	忠和堂供应链
滨州格森电子商务有限公司	格森
东海县晨耀珠宝有限公司	晨耀珠宝
昆山一月清洁设备有限公司	一月清洁
六盘水众睿文化传媒有限公司	众睿
物卡智能科技（深圳）有限公司	物卡智能
西宁市城北区兰亭食品店	兰亭食品店
桐乡市梧桐艳子服装网店	梧桐艳子服装网店
西安微易通网络科技有限公司	微易通
长沙曲速网络技术有限公司	曲速
苏州百加慕服饰有限公司	百加慕
南阳市宛城区鹏翔家庭服务中心	鹏翔家庭
